SSSSSSSSPRRRRRPSPRRRRRRRRRRRRRRR
SSSSSSSSSSSSSSSSPRPPPPPPPPPPPPSS
SSPPPRRRPRRRRRRRPRRRRRRRRRRRRRRR
SSSSSSSSSSSSSSSSPRRRPPPSSSSSSSSS
SSSPPRRPPRRRRRRRPRRRRRRRRRRRRRRR
SSSSSSSSSSSSSSSSPRRRRRRPPPPPPSSS
SSSPPRRRPRRRRRRRPRRRRRRRRRRRRRRR
SSSSSSPPPRPPPPPPPRRRRRRRRRRRRRRR
SSSSSSSSPRPPPPPPPRRRRRRRRRRRRRRR
SSSPPPPPPRRRRRRPPRRRRRRRRRRRRRRR
SSSSSSSSSSSSSSPPPRPPPPPPPPPPPPPP
SSSSSSSSSSSSSSSSPRRRPPPPSSSSSSSS
SSSSSSSSSSSSSSSSPRRRRRRRRSSSSSSS
SSSPPPPPPRRRRPPPPRRRRRRRRRRRRRRR
SSPRPRRRPRRRRRRRPRRRRRRRRRRRRRRR
SSSSSSSSSSPPPPPPPRRRRRRRRRPPPPPP
SSSSSSSSSSSSSSSSPRRRRRRRRRRRSSSS
SSPPPPPPPPPPPPPPPRRRRRRRRRRRPPPP
SSSSSSSSSSSSSSSSPRRRPPPPPPPPPPPS
SSSSPRRPPRRRRRRRPRRRRRRRRRRRRRRR
SSSSPPPPPPPPPPPPPRRRRRRRRRRPPPPP
SSSSSSSSPRRPPPSSPRRRRRRRRRRRRRRR
SSSSSSSSPRRRRPSSPRRRRRRRRRRRRRRR
SPPPPPPPPPPPPPPPPRRRRRRRRRRRRPPP
SSPPPPPPPRRPPPPPPRRRRRRRRRRRRRRR
SSSSPRSSPRRRRRRRPRRRRRRRRRRRRRRR
SSSSPPPPPPPPPPPPPRRRRRRRRRRRRRRP
SPPPPPPPPRRRRRRPPRRRRRRRRRRRRRRR
SSSSSSPPPPPPPPPPPRRRRRRRRRRRPPPP
SSSSSSSSSSSPPPPPPRRRRRRRRRRRRRRP
SSSSSSSSPRPPPSSSPRRRRRRRRRRRRRRR
SSSSSSSPPRRRRRPPPRRRRRRRRRRRRRRR
SSSSSSSSSSSSSSSSPRRRRRRRRRPPPPPP
SSSSSSSSPRRRRPSSPRRRRRRRRRRRRRRR
SSSPPPPPPPPPPPPPPRRRRRRRRRRRRRRR
SSSSSPPPPPPPPPPPPRRRRRPPPPPPPPPP
SSSSSSSSSSPPPPPPPRRRRRPPPPPPPPPP
SPPPPPPPPPPPPPPPPRRRRRRRRRRPPPPP
SSSPPPPPPRPPPPPPPRRRRRRRRRRRRRRR
SSSSSSSSPRRRRPSSPRRRRRRRRRRRRRRR
SSSSSSSSSSSSSSSSPRRRRRRRRRRRRRRR
SPPPPPPPPPPPPPPPPRRRRRRRRRRRPPPP
SSSSSSSSPRRRRPPPPRRRRRRRRRRRRRRR
SSSSSSSSPRPPSSSSPRRRRRRRRRRRRRRR
SSSSSPPPPRRRRRRPPRRRRRRRRRRRRRRR
SSSSSSSSPRRRRRSSPRRRRRRRRRRRRRRR
SSSSSSSSSSSSPPPPPRRRRRRRRRRRRRRR
SSSSSSSSSSPPPPPPPRRPPPPPPPPPPPPP
SSSSSSSSSSSSSSSSPRRRRRRRRRRRRRPP
SSSPPPPPPRRRRRPPPRRRRRRRRRRRRRRR
