SSSSSSSSPRRPPPPSPRRRRRRRRRRRRRRR
SSSSSSSSSSSSPPPPPRRRRRRRRRRRRPPP
SSSSSSSSPRRRRRSSPRRRRRRRRRRRRRRR
SPPPPPPPPRRRRRRRPRRRRRRRRRRRRRRR
SSSSSSSPPRRPPPPPPRRRRRRRRRRRRRRR
SSSPPPPPPRRRRRPPPRRRRRRRRRRRRRRR
SPPPPRRRPRRRRRRRPRRRRRRRRRRRRRRR
SSSSSSSSSSSSSPPPPRRPPPPPPPPPPPPP
SSPPPPPPPRRRRRPPPRRRRRRRRRRRRRRR
SSSSSSSPPRRRPPPPPRRRRRRRRRRRRRRR
SSSSSSSSPRRPSSSSPRRRRRRRRRRRRRRR
SSSSSSSPPPPPPPPPPRRRRRRRRRRRPPPP
SSSSSSPPPPPPPPPPPRRRRRRRRRRRRPPP
SSSSPRRSPRRRRRRRPRRRRRRRRRRRRRRR
SPPRPRRRPRRRRRRRPRRRRRRRRRRRRRRR
SSSSSSSPPRRPPPPPPRRRRRRRRRRRRRRR
SSSSSSSSPRRRRSSSPRRRRRRRRRRRRRRR
SSSSPRRSPRRRRRRRPRRRRRRRRRRRRRRR
SPPPPRPPPRRRRRRRPRRRRRRRRRRRRRRR
SSSPPRPPPRRRRRRRPRRRRRRRRRRRRRRR
SSSSSSSSSSSSSSSSPRRRRRPPPPPPPPPP
SSSSSPPPPRRRRRRRPRRRRRRRRRRRRRRR
SSSSSSSSSSSSSSSPPRRRRRRRRRPPPPPP
SSPPPPPPPRRRRRRRPRRRRRRRRRRRRRRR
SSSSSSSSSSSSSPPPPRRRRRRRRRRRPPPP
SSSSSSSSPRRRPPPSPRRRRRRRRRRRRRRR
SSSSSSSSSSSSSSPPPRRRRRRRRRRPPPPP
SSSSSSSSSSSSSSSSPRRRPPPPPPPPPSSS
SSSSSSSSPRRPSSSSPRRRRRRRRRRRRRRR
SSSSSSSPPRRRRRRPPRRRRRRRRRRRRRRR
SSSSSSSSSSSSSSSSPRRRRRPPPPPSSSSS
SSSSSSSSPRRRRRRRPRRRRRRRRRRRRRRR
SSSSSSSSPRRPPSSSPRRRRRRRRRRRRRRR
SSSSSSSSSPPPPPPPPRRRRRRRRRRRRRRP
SPPPPPPPPPPPPPPPPRPPPPPPPPPPPPPP
SSPPPRRPPRRRRRRRPRRRRRRRRRRRRRRR
SSSSSSSSSSSSSSSSPRRRRRSSSSSSSSSS
SSSSSSSSSSSSSSSSPRRPPPPPPPPSSSSS
SSSSSSSSPRRPPPSSPRRRRRRRRRRRRRRR
SSPPPRPPPRRRRRRRPRRRRRRRRRRRRRRR
SSSPPPPPPPPPPPPPPRRRRRRRRRRRRRRR
SSSSSSSSSSSPPPPPPRRRRRRRPPPPPPPP
SPPPPPPPPRRRRRPPPRRRRRRRRRRRRRRR
SSSSSSPPPPPPPPPPPRRRRRRRRRRRPPPP
SSSSSSSSPRRRRRPSPRRRRRRRRRRRRRRR
SSSSPRSSPRRRRRRRPRRRRRRRRRRRRRRR
SSSSSSSSSSSSSSSSPRRRRRRRRRRPSSSS
SSSPPRPPPRRRRRRRPRRRRRRRRRRRRRRR
SSSSSSSSSSSSSSSSPRPPPPSSSSSSSSSS
SSSSSSSSPRRRRRRRPRRRRRRRRRRRRRRR
