SSSSSSSSSSSSSSSSSSSSSSSSSSSSSSSSSSSSSSSSSSSSSSSSSSSSSSSSSSPPPPPPPRRRRRRRRRRRRRRRRRRRRRRRRRRRRRRRRRRPPPPPPPPPPPPPPPPPPPPPPPPPPPPP
SSSSSSSSSSSSSSSSSSSSSSSSSSSSSSSSSSSSSSSPPPPPPPPPPPPPPPPPPPPPPPPPPRRRRRRRRRRRRRRRRRRRRRRRRRRRRPPPPPPPPPPPPPPPPPPPPPPPPPPPPPPPPPPP
SSSSSSSSSSSSSSSSSSSSSSSSSSSSSSSSPRPPPPSSSSSSSSSSSSSSSSSSSSSSSSSSPRRRRRRRRRRRRRRRRRRRRRRRRRRRRRRRRRRRRRRRRRRRRRRRRRRRRRRRRRRRRRRR
SSSSPPPPPPPPPPPPPRRRPPPPPPPPPPPPPRRRRRRRRRRRRRRRRRRRRRRRRRRRRRRRPRRRRRRRRRRRRRRRRRRRRRRRRRRRRRRRRRRRRRRRRRRRRRRRRRRRRRRRRRRRRRRR
SSSSPPPPPPPPPPPPPPPPPPPPPPPPPPPPPRRRRRRRPPPPPPPPPPPPPPPPPPPPPPPPPRRRRRRRRRRRRRRRRRRRRRRRRRRRRRRRRRRRRRRRRRRRRRRRRRRRRRRRRRRRRRRR
SSSSSSSSSSSSSSSSSSSSSSSPPPPPPPPPPPPPPPPPPPPPPPPPPPPPPPPPPPPPPPPPPRRRRRPPPPPPPPPPPPPPPPPPPPPPPPPPPPPPPPPPPPPPPPPPPPPPPPPPPPPPPPPP
SSSSSSSSSSSSSSSSSSSSSSSSSSSSSSSSSSSSSSSSSSSSSSSSSSSSSSSSPPPPPPPPPRRRRRRRRRRRRRRRRRRRRPPPPPPPPPPPPPPPPPPPPPPPPPPPPPPPPPPPPPPPPPPP
SSPPPPPPPPPPPPPPPRRRRRRRRPPPPPPPPRRRRRRRRRRRRRRRRRRRRRRRRRRRRRRRPRRRRRRRRRRRRRRRRRRRRRRRRRRRRRRRRRRRRRRRRRRRRRRRRRRRRRRRRRRRRRRR
SSSSSSSSSSSSSSSSSSSSSPPPPPPPPPPPPPPPPPPPPPPPPPPPPPPPPPPPPPPPPPPPPRRRRRRRRRRRRRRRRRRRRRRRRRRRRRRRRRRRRPPPPPPPPPPPPPPPPPPPPPPPPPPP
SSSSSSSSSSSSSSSSSSSSSSSSSSSSSSSSSSSSSSSSSSSSPPPPPPPPPPPPPPPPPPPPPRRRRRRRPPPPPPPPPPPPPPPPPPPPPPPPPPPPPPPPPPPPPPPPPPPPPPPPPPPPPPPP
SSSSSSSSSSSSSSSSSSSSSSSSSSSSSSSSSSSSSPPPPPPPPPPPPPPPPPPPPPPPPPPPPRRRRRRRRRRRRRRRRRRRRRRRRRRRRPPPPPPPPPPPPPPPPPPPPPPPPPPPPPPPPPPP
SSSSSSSSSSSSSSSSSSSSSSSSSSSSSSSSSSSSSSSSSSSSSSSSSSSPPPPPPPPPPPPPPRRRRRRRRRRRRRRRRRRRRRRRRRRRRRRRRRRRRRRRRRRRRRRRRRRRPPPPPPPPPPPP
SPPPPPPPPPPPPPPPPRRRRRRRRRRRPPPPPRRRRRRRRRRRRRRRRRRRRRRRRRRRRRRRPRRRRRRRRRRRRRRRRRRRRRRRRRRRRRRRRRRRRRRRRRRRRRRRRRRRRRRRRRRRRRRR
SSSSSSSSSSSSSSSSSSSSSSSSSSSSSSSSSSSSSSSSSSSSSSSSSSSSSSPPPPPPPPPPPRRRRRRRRRRRPPPPPPPPPPPPPPPPPPPPPPPPPPPPPPPPPPPPPPPPPPPPPPPPPPPP
SSSSSSSSSSSSSSSSSSPPPPPPPPPPPPPPPPPPPPPPPPPPPPPPPPPPPPPPPPPPPPPPPRRRRRRRRRRRRRRRRRRRRRRRRRRRRRRPPPPPPPPPPPPPPPPPPPPPPPPPPPPPPPPP
SSSSSSSSSSSSSSSSSSSSSSSSSSSSSSSSSSSSSSSSSSSSSSPPPPPPPPPPPPPPPPPPPRRRRRRRRRRRRRRRRRRRRRRRRRRRRRRRRRRRRRRRPPPPPPPPPPPPPPPPPPPPPPPP
SSSSSSSSSSSSSSSSSSSSSSSSSSSSSSSSSSPPPPPPPPPPPPPPPPPPPPPPPPPPPPPPPRRRRRRRRRRRRRRRRRRRRRRPPPPPPPPPPPPPPPPPPPPPPPPPPPPPPPPPPPPPPPPP
SSSSSSSSSSSSSSSSSSSSSSSSPPPPPPPPPPPPPPPPPPPPPPPPPPPPPPPPPPPPPPPPPRRRRPPPPPPPPPPPPPPPPPPPPPPPPPPPPPPPPPPPPPPPPPPPPPPPPPPPPPPPPPPP
SSSSSSSSSSSSSSSSSSSSSSSSSSSSSSSSPRRRRRRRRRRRRRRRPPPPPPPPSSSSSSSSPRRRRRRRRRRRRRRRRRRRRRRRRRRRRRRRRRRRRRRRRRRRRRRRRRRRRRRRRRRRRRRR
SSSSSSSSSSSPPPPPPRRRRRRRRRRRRRRPPRRRRRRRRRRRRRRRRRRRRRRRRRRRRRRRPRRRRRRRRRRRRRRRRRRRRRRRRRRRRRRRRRRRRRRRRRRRRRRRRRRRRRRRRRRRRRRR
SSSSSSSSSSSSSSSSSSSSSSSSSSSSSSSSSSSSSSPPPPPPPPPPPPPPPPPPPPPPPPPPPRRRRRRRRRRRRRRRRRRRRRRRRRRRRRRRRRRRRRRRRRRRRRRRRRRRRRPPPPPPPPPP
SSPPPPPPPRRRRRPPPRRRRRRRRRRRRRRRPRRRRRRRRRRRRRRRRRRRRRRRRRRRRRRRPRRRRRRRRRRRRRRRRRRRRRRRRRRRRRRRRRRRRRRRRRRRRRRRRRRRRRRRRRRRRRRR
SSSSSSSSSSSSSSSSSSSSSSSSSSSSSSSSSSSSSSPPPPPPPPPPPPPPPPPPPPPPPPPPPRRRRRRRRRRRRRRRRRRRRRRRRRRRRRRRRRPPPPPPPPPPPPPPPPPPPPPPPPPPPPPP
SSSSSSSSSSSSSSSSSSSSSSSSSSSSSSSSPRRRRRRRRRRRRRRRRRRRRRRRRPPPPSSSPRRRRRRRRRRRRRRRRRRRRRRRRRRRRRRRRRRRRRRRRRRRRRRRRRRRRRRRRRRRRRRR
SSSSSSSSSSSSSSSSSSSSSSSSSSSSSSSSSSSSSSSSSSSSSSSSSSSSSSSSSSSSSSSSPRRRRRRRRRRRRRRRRRRRRRRRRRRRRRRRRRRRRRRRRRRRRRRRRRRPPPPPPPPSSSSS
SSSSSSSSSSSSSSSSSSSSSSSSSSSPPPPPPPPPPPPPPPPPPPPPPPPPPPPPPPPPPPPPPRRRRRRRRRRRRRRRRRRRRRRRRRRRRRRRRRRRRRRRRRRPPPPPPPPPPPPPPPPPPPPP
SSSSSSSSSSSSSSSSSSSSSSSSSSSSSSSSPRRRRRRRRRRPSSSSSSSSSSSSSSSSSSSSPRRRRRRRRRRRRRRRRRRRRRRRRRRRRRRRRRRRRRRRRRRRRRRRRRRRRRRRRRRRRRRR
SSSSSSSSSSSSSSSSSSSSSSSSSSSSSSSSPRRRRRRRRRRRRRRRRRRRRRRRPPPPPPPSPRRRRRRRRRRRRRRRRRRRRRRRRRRRRRRRRRRRRRRRRRRRRRRRRRRRRRRRRRRRRRRR
SSSSSSSSSSSSSSSSPRRPPPPPPSSSSSSSPRRRRRRRRRRRRRRRRRRRRRRRRRRRRRRRPRRRRRRRRRRRRRRRRRRRRRRRRRRRRRRRRRRRRRRRRRRRRRRRRRRRRRRRRRRRRRRR
SSSSSSSSSSSSSSSSSSSSSSSSSSSSPPPPPPPPPPPPPPPPPPPPPPPPPPPPPPPPPPPPPRRRRRRRRRRRRRRRRRRRRRRRRRRRRRRRRRRRRRRRRRPPPPPPPPPPPPPPPPPPPPPP
SSSSSSSSSSPPPPPPPRRRRRRPPPPPPPPPPRRRRRRRRRRRRRRRRRRRRRRRRRRRRRRRPRRRRRRRRRRRRRRRRRRRRRRRRRRRRRRRRRRRRRRRRRRRRRRRRRRRRRRRRRRRRRRR
SPPPPPPPPPPPPPPPPPPPPPPPPPPPPPPPPRRRRRRRRRRRRRRRRRRRRRRRRPPPPPPPPRRRRRRRRRRRRRRRRRRRRRRRRRRRRRRRRRRRRRRRRRRRRRRRRRRRRRRRRRRRRRRR
SPPPPPPPPPPPPPPPPRRRRRRRRRPPPPPPPRRRRRRRRRRRRRRRRRRRRRRRRRRRRRRRPRRRRRRRRRRRRRRRRRRRRRRRRRRRRRRRRRRRRRRRRRRRRRRRRRRRRRRRRRRRRRRR
SSSSSSSSSSSSSSSSSSSSSSSSSSSSSSSSSSSSSSSSSSSSSSSSSSSSSSSSSSSSSSSSPRRRRRRRRRPPPPPPPPPPPPPPPPPPPPPPPPPPPPPPPPPPPPPPPPPPPPPSSSSSSSSS
SSSSSSSSSSSSSSSSPRRRRRRRRPPPPPPSPRRRRRRRRRRRRRRRRRRRRRRRRRRRRRRRPRRRRRRRRRRRRRRRRRRRRRRRRRRRRRRRRRRRRRRRRRRRRRRRRRRRRRRRRRRRRRRR
SSSSSSPPPRRRRRPPPRRRRRRRRRRRRRRRPRRRRRRRRRRRRRRRRRRRRRRRRRRRRRRRPRRRRRRRRRRRRRRRRRRRRRRRRRRRRRRRRRRRRRRRRRRRRRRRRRRRRRRRRRRRRRRR
SSSSSPPPPPPPPPPPPPPPPPPPPPPPPPPPPPPPPPPPPPPPPPPPPPPPPPPPPPPPPPPPPRRRRRRRRRRRRRRRRRRRRRRRRRRRRRRRRRRRRRRRRRRRRRRRRRRRRRRRRRPPPPPP
SSSSSSSSSSSSSSSSSSSSSSSSSSSSSSSSSSSSSSSSSSSSSSSSSSSSSSSSSSSSSSSSPRRRRRRRRRRRRRRRRRRRRRRRRRRRRRRRRRRRRRRSSSSSSSSSSSSSSSSSSSSSSSSS
SPPPPPPPPPPPPPPPPPPPPPPPPPPPPPPPPPPPPPPPPPPPPPPPPPPPPPPPPPPPPPPPPRRRRRRRRRRRRRRRRRRRRRRRRRRRRRRRRRRRRRRRRRRRRRPPPPPPPPPPPPPPPPPP
SSSSSSSSSSSSSSSSSSSSSSSSSPPPPPPPPPPPPPPPPPPPPPPPPPPPPPPPPPPPPPPPPRRRRRRRRRRRRRRRRRRRRRRRRRRRRRRRRPPPPPPPPPPPPPPPPPPPPPPPPPPPPPPP
SSPPPRRPPRRRRRRRPRRRRRRRRRRRRRRRPRRRRRRRRRRRRRRRRRRRRRRRRRRRRRRRPRRRRRRRRRRRRRRRRRRRRRRRRRRRRRRRRRRRRRRRRRRRRRRRRRRRRRRRRRRRRRRR
SSSSSSSSSSSSSPPPPPPPPPPPPPPPPPPPPPPPPPPPPPPPPPPPPPPPPPPPPPPPPPPPPRRRRRRRRRRRRRRRRRRRRRRRPPPPPPPPPPPPPPPPPPPPPPPPPPPPPPPPPPPPPPPP
SSSSPRPPPRRRRRRRPRRRRRRRRRRRRRRRPRRRRRRRRRRRRRRRRRRRRRRRRRRRRRRRPRRRRRRRRRRRRRRRRRRRRRRRRRRRRRRRRRRRRRRRRRRRRRRRRRRRRRRRRRRRRRRR
SSSSSSSSSSSSSSSSSSSSSSSSSSSSSSSSSSSSSSSSSSSSSSSSSSSSSSSSSSSSSSSSPRRRRRRRSSSSSSSSSSSSSSSSSSSSSSSSSSSSSSSSSSSSSSSSSSSSSSSSSSSSSSSS
SSSSSSSSSSSSSSSSPRRRRRPSSSSSSSSSPRRRRRRRRRRRRRRRRRRRRRRRRRRRRRRRPRRRRRRRRRRRRRRRRRRRRRRRRRRRRRRRRRRRRRRRRRRRRRRRRRRRRRRRRRRRRRRR
SSSSSSSSSSSSSSSSSSSSSSSSSSSSSSSPPRRRRRRRRRRRRRRRRRRRRRRRRRRRPPPPPRRRRRRRRRRRRRRRRRRRRRRRRRRRRRRRRRRRRRRRRRRRRRRRRRRRRRRRRRRRRRRR
SSSSPPPPPRRRRRRRPRRRRRRRRRRRRRRRPRRRRRRRRRRRRRRRRRRRRRRRRRRRRRRRPRRRRRRRRRRRRRRRRRRRRRRRRRRRRRRRRRRRRRRRRRRRRRRRRRRRRRRRRRRRRRRR
SSSSSSSSSSSSSSSSSSSSSSSSSSSSSSSSSSSSSSSSSSSSSSPPPPPPPPPPPPPPPPPPPRRRRRRRRRRRRRRRRRRRRRRRRRRRRRRRRRRRRRRRRRRRRRRPPPPPPPPPPPPPPPPP
SSSSSSSSSSSSSSSSSSSSSSSSSSSSSSSSSSSSSSSSSSSSSSSSSSSSSPPPPPPPPPPPPRRRPPPPPPPPPPPPPPPPPPPPPPPPPPPPPPPPPPPPPPPPPPPPPPPPPPPPPPPPPPPP
SSSSSSSSSSSSSSSSSPPPPPPPPPPPPPPPPRRRRRRRRRRRRRRRRRRRRRPPPPPPPPPPPRRRRRRRRRRRRRRRRRRRRRRRRRRRRRRRRRRRRRRRRRRRRRRRRRRRRRRRRRRRRRRR
SSSSSSSSSSSSPPPPPRRRRRRRRPPPPPPPPRRRRRRRRRRRRRRRRRRRRRRRRRRRRRRRPRRRRRRRRRRRRRRRRRRRRRRRRRRRRRRRRRRRRRRRRRRRRRRRRRRRRRRRRRRRRRRR
SSSSSSSSSSSSSSSSSSSSPPPPPPPPPPPPPPPPPPPPPPPPPPPPPPPPPPPPPPPPPPPPPRRRRRRRPPPPPPPPPPPPPPPPPPPPPPPPPPPPPPPPPPPPPPPPPPPPPPPPPPPPPPPP
SSSSSSSSSSSSSSSSSPPPPPPPPPPPPPPPPRRRRRRRRRRRRRRRRRRRRRRRRRRPPPPPPRRRRRRRRRRRRRRRRRRRRRRRRRRRRRRRRRRRRRRRRRRRRRRRRRRRRRRRRRRRRRRR
SSSSSSSSSSSSSSSSSSSSSSSSSSSSSSSSSSSSSSSSSSSSSSSSSSSSSSSSSSPPPPPPPRRRRRRRRRRRRRRRRRRRRRPPPPPPPPPPPPPPPPPPPPPPPPPPPPPPPPPPPPPPPPPP
SSSSSSSSSSSSSSSSSSSSSSSSSSSSSSSSSSSPPPPPPPPPPPPPPPPPPPPPPPPPPPPPPRRRRRRRRRRRRRRRRRRRRRRRRPPPPPPPPPPPPPPPPPPPPPPPPPPPPPPPPPPPPPPP
SSSSSSSSSSPPPPPPPRRRRRRRRRRPPPPPPRRRRRRRRRRRRRRRRRRRRRRRRRRRRRRRPRRRRRRRRRRRRRRRRRRRRRRRRRRRRRRRRRRRRRRRRRRRRRRRRRRRRRRRRRRRRRRR
SSSSSSSSSSSSSSPPPRRPPPPPPPPPPPPPPRRRRRRRRRRRRRRRRRRRRRRRRRRRRRRRPRRRRRRRRRRRRRRRRRRRRRRRRRRRRRRRRRRRRRRRRRRRRRRRRRRRRRRRRRRRRRRR
SSSSSSSSSPPPPPPPPPPPPPPPPPPPPPPPPRRRRRRRRRRRRRRRRRRRRPPPPPPPPPPPPRRRRRRRRRRRRRRRRRRRRRRRRRRRRRRRRRRRRRRRRRRRRRRRRRRRRRRRRRRRRRRR
SSSSSSSSSSSSSSSPPPPPPPPPPPPPPPPPPPPPPPPPPPPPPPPPPPPPPPPPPPPPPPPPPRRRRRRRRRRRRRRPPPPPPPPPPPPPPPPPPPPPPPPPPPPPPPPPPPPPPPPPPPPPPPPP
SSSSSSSSSSSSSSSSSSSSSSSSSSSSSSSSSSSSSSSSSSSSSSSSSSSSSSSSSSSSSSSSPRRRRRRRRRRRRRRRRRRRRRRRRRRPPPPPPPPPPPPPPPPPPPPPPPPPPSSSSSSSSSSS
SSSSSSSSSSSSSSSSPRRRPPPPPPPPPPPPPRRRRRRRRRRRRRRRRRRRRRRRRRRRRRRRPRRRRRRRRRRRRRRRRRRRRRRRRRRRRRRRRRRRRRRRRRRRRRRRRRRRRRRRRRRRRRRR
SSSSSSSSSSSSSSSSSSSSSSSSPPPPPPPPPRRRRRRRRRRRRRRRRRRRRRRRRRRRRPPPPRRRRRRRRRRRRRRRRRRRRRRRRRRRRRRRRRRRRRRRRRRRRRRRRRRRRRRRRRRRRRRR
SSSSSSSPPRRRRRRRPRRRRRRRRRRRRRRRPRRRRRRRRRRRRRRRRRRRRRRRRRRRRRRRPRRRRRRRRRRRRRRRRRRRRRRRRRRRRRRRRRRRRRRRRRRRRRRRRRRRRRRRRRRRRRRR
SSSSSSSSSSSSSSSSSSSSSSSSSSSSSSSSPRRRRRRRRPPPPPPPPPPPPPPPSSSSSSSSPRRRRRRRRRRRRRRRRRRRRRRRRRRRRRRRRRRRRRRRRRRRRRRRRRRRRRRRRRRRRRRR
SSSSSSSSSSSSSSSSSSSSSSSSSSSSSSSSSSSSSSSSSSSSSSSSSSSSSSSSSSSSSSSSPRRRRRRRRRPPPPPPPPPPPPPPPPPPPPPPPSSSSSSSSSSSSSSSSSSSSSSSSSSSSSSS
SSSSSSSSSSSSSSSSSSSSSSSSSSSSSSPPPPPPPPPPPPPPPPPPPPPPPPPPPPPPPPPPPRRRRRRRRRRRRRRRRRRRRRRRRRRPPPPPPPPPPPPPPPPPPPPPPPPPPPPPPPPPPPPP
SSSPPRRPPRRRRRRRPRRRRRRRRRRRRRRRPRRRRRRRRRRRRRRRRRRRRRRRRRRRRRRRPRRRRRRRRRRRRRRRRRRRRRRRRRRRRRRRRRRRRRRRRRRRRRRRRRRRRRRRRRRRRRRR
SSSSSSSSSSSSSSSSSSSSSSSSSSSSSSSSSSSSSSSSSSSSSSSSSSSSSSSSSSSSSSSSPRRRRRRRRRRRRPPPPPPPPPPPPPPPPPPPPPPPPPPPPPPPPPPPPPPPPPPPPPPPPPPS
SSSSSSSPPPPPPPPPPPPPPPPPPPPPPPPPPPPPPPPPPPPPPPPPPPPPPPPPPPPPPPPPPRRRRRRRRRRRRRRPPPPPPPPPPPPPPPPPPPPPPPPPPPPPPPPPPPPPPPPPPPPPPPPP
SSSSSSSSSSSSPPPPPPPPPPPPPPPPPPPPPRRRRRRRRRRRRRRRRRRRRRPPPPPPPPPPPRRRRRRRRRRRRRRRRRRRRRRRRRRRRRRRRRRRRRRRRRRRRRRRRRRRRRRRRRRRRRRR
SSSSSSSSSSSSSSSSSSSSSSSSSSSSSSSSSSSSSSSSSPPPPPPPPPPPPPPPPPPPPPPPPRRRRRRRRRRRRRRRRRRRRRRRPPPPPPPPPPPPPPPPPPPPPPPPPPPPPPPPPPPPPPPP
SSSSSSSSSSSSSSSSSSSSSSSSSSSSSSSSPRRRRRRRPPPPPPPPPPPPPSSSSSSSSSSSPRRRRRRRRRRRRRRRRRRRRRRRRRRRRRRRRRRRRRRRRRRRRRRRRRRRRRRRRRRRRRRR
SSPRPRRRPRRRRRRRPRRRRRRRRRRRRRRRPRRRRRRRRRRRRRRRRRRRRRRRRRRRRRRRPRRRRRRRRRRRRRRRRRRRRRRRRRRRRRRRRRRRRRRRRRRRRRRRRRRRRRRRRRRRRRRR
SSSSSSSSSSSSSSSSSSSSSSSSSSSSSSSSSSSSSSSSSSSSSSSSSSSSSSSSSSSSPPPPPRRRRRRPPPPPPPPPPPPPPPPPPPPPPPPPPPPPPPPPPPPPPPPPPPPPPPPPPPPPPPPP
SSSSSSSSSSSSSSSSSSSSSSSSSSSSSSSSSSSSSSSSSSSSSSSSSSSSSSSSSSSSSSSSPRRRRRRRRRPPPPPPPPPPPPPPPPPPPPPPPPPSSSSSSSSSSSSSSSSSSSSSSSSSSSSS
SSSPPPPPPPPPPPPPPPPPPPPPPPPPPPPPPRRRRRRRRRRRRRRRRRRRRRRRRRRRRPPPPRRRRRRRRRRRRRRRRRRRRRRRRRRRRRRRRRRRRRRRRRRRRRRRRRRRRRRRRRRRRRRR
SPPPPRRPPRRRRRRRPRRRRRRRRRRRRRRRPRRRRRRRRRRRRRRRRRRRRRRRRRRRRRRRPRRRRRRRRRRRRRRRRRRRRRRRRRRRRRRRRRRRRRRRRRRRRRRRRRRRRRRRRRRRRRRR
SSSSSSSSSSSSSSSSSSSSSSSSSSSSSSSSSSSSSSSSSSSSSSPPPPPPPPPPPPPPPPPPPRRRRRRRRRRRRRRRRRRRRRRRRRRRRRRRRRRRRRRRPPPPPPPPPPPPPPPPPPPPPPPP
SSSSSSSSSSSSSSSSSSSSSSSSSSSSSSSSPRRRRRRPPPPPPPPPPPPSSSSSSSSSSSSSPRRRRRRRRRRRRRRRRRRRRRRRRRRRRRRRRRRRRRRRRRRRRRRRRRRRRRRRRRRRRRRR
SSSSSSSSSSSSSSSSSSSSSSSSSSSSSSSSSSSSSSSSSSSSSSSSSSSPPPPPPPPPPPPPPRRRRRRRRRRRRRRRRRRRRRRRRRRPPPPPPPPPPPPPPPPPPPPPPPPPPPPPPPPPPPPP
SSSSPPPPPPPPPPPPPPPPPPPPPPPPPPPPPPPPPPPPPPPPPPPPPPPPPPPPPPPPPPPPPRRRRRRRRRRRRRRRRRRRRRRRRRRRRRRRRRRRRRRRPPPPPPPPPPPPPPPPPPPPPPPP
SSSSSSSSSSSSSSSSSPPPPPPPPPPPPPPPPPPPPPPPPPPPPPPPPPPPPPPPPPPPPPPPPRRRRRRRRRRRRRRRRRRRRRRRRRRRRRRRPPPPPPPPPPPPPPPPPPPPPPPPPPPPPPPP
SSSSSSSSSSSSSSSSSSSSSSSSSSSSSSSSSSSSSSSSSSSSSSSSSSSSSSSSSSSSSSSSPRRRRRRRRRRRRRRRRRRRRRRRRRRRRRRRRRRRRRRRRRRRRRRRRRRRRRRRPPPPPSSS
SSSSSSSSSSSSSSSSSSSSSSSSSSSSSSSSPRRRRRRRRRRSSSSSSSSSSSSSSSSSSSSSPRRRRRRRRRRRRRRRRRRRRRRRRRRRRRRRRRRRRRRRRRRRRRRRRRRRRRRRRRRRRRRR
SSSSSSSSSSSSSSSSSSSSSSSSSSSSSSSSSSSSSSSSSSSSSSSSSSSSSSSSSSSSSSPPPRRRRRRRRRRRRRRRRRRRRRRRPPPPPPPPPPPPPPPPPPPPPPPPPPPPPPPPPPPPPPPP
SSSSSSSSSSSSSSSSSSSSSSSSSSSSSSSSPRPPPPPPPPPPPPPPPPPPPPPSSSSSSSSSPRRRRRRRRRRRRRRRRRRRRRRRRRRRRRRRRRRRRRRRRRRRRRRRRRRRRRRRRRRRRRRR
SSSSSSSSSSSSPPPPPPPPPPPPPPPPPPPPPPPPPPPPPPPPPPPPPPPPPPPPPPPPPPPPPRRRRRRRRRRRRRRRRRRRRRRPPPPPPPPPPPPPPPPPPPPPPPPPPPPPPPPPPPPPPPPP
SSSSSSSSSSSSSSSSSSSSSSSSSSSSSSSSSSSSSSSSSSSSSSSSSSSPPPPPPPPPPPPPPRRRRRRRRRRRRPPPPPPPPPPPPPPPPPPPPPPPPPPPPPPPPPPPPPPPPPPPPPPPPPPP
SSSSSSSSSSSSSSSSSSSSSSSSSSSSSSSSPRRRRRRRRRRRRRRRRRRRRRRRPPPPPPPSPRRRRRRRRRRRRRRRRRRRRRRRRRRRRRRRRRRRRRRRRRRRRRRRRRRRRRRRRRRRRRRR
SSSSSSSSSSSSSSSSPRRRRRRRRRRPSSSSPRRRRRRRRRRRRRRRRRRRRRRRRRRRRRRRPRRRRRRRRRRRRRRRRRRRRRRRRRRRRRRRRRRRRRRRRRRRRRRRRRRRRRRRRRRRRRRR
SSSSSSSSSSSSSSSSSSSSSSSSSSSSSSSSSSSSSSSSSSSSSSSSSSSSSSSSSSSSSSSSPRRRRRRRRRRRRRRRRPPPPPPPPPPPPPPPPPPPPPPPPPPPPPPPPPPPPSSSSSSSSSSS
SSSSSSSSSSSSSSSSPRRRRRRRRRPPPPPSPRRRRRRRRRRRRRRRRRRRRRRRRRRRRRRRPRRRRRRRRRRRRRRRRRRRRRRRRRRRRRRRRRRRRRRRRRRRRRRRRRRRRRRRRRRRRRRR
SSSSSSSSSSSSSPPPPPPPPPPPPPPPPPPPPRRRRRRRRRRRRRRRRPPPPPPPPPPPPPPPPRRRRRRRRRRRRRRRRRRRRRRRRRRRRRRRRRRRRRRRRRRRRRRRRRRRRRRRRRRRRRRR
SSSSSSSSPPPPPPPPPRRPPPPPPPPPPPPPPRRRRRRRRRRRRRRRRRRRRRRRRRRRRRRRPRRRRRRRRRRRRRRRRRRRRRRRRRRRRRRRRRRRRRRRRRRRRRRRRRRRRRRRRRRRRRRR
SSSSSSSSSSSSSSPPPRRPPPPPPPPPPPPPPRRRRRRRRRRRRRRRRRRRRRRRRRRRRRRRPRRRRRRRRRRRRRRRRRRRRRRRRRRRRRRRRRRRRRRRRRRRRRRRRRRRRRRRRRRRRRRR
SSSSSSSSSSSSSSSSSSSSSSSSSSSSSSSSPRRPPPPPPPPPPPPSSSSSSSSSSSSSSSSSPRRRRRRRRRRRRRRRRRRRRRRRRRRRRRRRRRRRRRRRRRRRRRRRRRRRRRRRRRRRRRRR
SSSSSSSSSSPPPPPPPPPPPPPPPPPPPPPPPRRPPPPPPPPPPPPPPPPPPPPPPPPPPPPPPRRRRRRRRRRRRRRRRRRRRRRRRRRRRRRRRRRRRRRRRRRRRRRRRRRRRRRRRRRRRRRR
SSSSSSSPPRRRRRRPPRRRRRRRRRRRRRRRPRRRRRRRRRRRRRRRRRRRRRRRRRRRRRRRPRRRRRRRRRRRRRRRRRRRRRRRRRRRRRRRRRRRRRRRRRRRRRRRRRRRRRRRRRRRRRRR
SSSSSSSSSSSSSSSSSSSSSSSSSSSSSSSSSSSSSSSSSSSSSSSSSSSSSSSSSSSSSSSSPRRRRRRRRRRRRRRRRRRRRRRPPPPPPPPPPPPPPPPPPPPPPPPPPPPPPPPPPPPPPPSS
SSSSSSSSPPPPPPPPPPPPPPPPPPPPPPPPPPPPPPPPPPPPPPPPPPPPPPPPPPPPPPPPPRRRRRRRRRRRRRRRRRRRRRRRRRRRRRRRRRRRRRRRRRRRRRRPPPPPPPPPPPPPPPPP
