RRPSSRSSRSSSSPSRSSSPRRRPSSPSPSPS
SRPPRRRRPRPRPRSRPPSSRSRRPSPSPPSS
RRPSRRRRRSPSSPSRSRSPPRPRSRRRPRSP
RPPSPPPPPPSRPPPSSPSRSRRSRRRPPSPS
PRPSSPSSSRRPSRRPPRPRRSRRPSRSSSRS
SSRRRRPSRRPRPRRPPPRSRSRSSPPPPSPP
RPSRPPSPSPSSSPRSSPSPSRPPSPRRSRRS
SPSRRSPPSPRPRRSSPRRPPRRRPSPPRSRS
RSSRRPPSRRSPRSPPRSRRRPRRRPSPSRPR
RRRPPPRPPRPPPPSSPRRRPRSRRSRPPRSP
RPRPRSSRSRSPSSPSRRPSSSSRRSSPRSRR
RRRSPRSPSPPRPRSSSPSPSPRPSPPSSRPP
SSRPPPPPSRSPRPSSPSPRPSRPRSRPRSRS
SRRPRPSRPPRRPRRPSSPPRSRRPPPSSPPP
PPRRSPRPSPSSPRRRPRRPSPPPSSRPSSPS
SPRPSSRPPRPSRSSPSSRSPPRPSRRPRSPR
PRPRSPPSSSPRSPSRPRRRSSPSPRPPSSRS
SRPSPSSPRRPRSSSPSRSSSPSSRRPSPPRS
SPSSRSRSSSRPRRRSRSRRPSRSRPSPPPRS
SSPRRSRRPSPRRRRSSSSRRSPRRPSPSPRP
SRRSRSSPPPRRPRSSPSSRRSPPRPRRSPPP
RPRRRRRPRSSRRRPPPPPRSPSPSRSSPSRS
SPRPRPSRPSPPRRPSRRPSSPPRPPRRPSPR
SPPSSSPRRPSRRRPPRSPSSPSRRPRRSRPS
RSRSSSSRSPSRSPPRSSPPRRPSPRPPPPRS
SRSPSPSRPSRSSSSPSPRPRPRPSSSRPRPS
PSSRPPSRRSPRSRRSPSPSRPSRSSPPSRPS
PRSSSSPPPSPPRRSSRRPSSSSRRRRSRSRP
RRPSSPRRRPRPPSPPSRPSSPPRPSRRRRSP
PSPSSSPRRRSPPPSPRSSRPPSRSRPPRRRP
RSSPPRSPPPRPPPPPRSSRSPSSSRPPSSRP
PPSSSSPRSPRPRRSSRPSSPSRPPRPSPRSR
PPSPRRSRRRRRPPRPSSPRRPSSPPPRRRRP
SSRPPSSSSPSRPPPSRSSPPPSRPSPRSSSS
SPRPRSPRSRRPRPRRSSPPRRRRSSPSSRRS
SPPSSRPPPSRSPPPRRRSRPSPSSSPSRPSP
PPSSRSPSPSRPRRSSRRPSPPSRPPRRSRRP
PSRRRSSPPSRSSRRSPPRSSPRSRRRPPRPR
SRPSRPSSSRSRRSRSRPRPPPRPSRRRSRSR
PRPRPPRPPRRRSPPPRRPSRRSSRRPSRSSP
RRPSSSSRSPSSPSRSRPSPPPSSRPSPPRPR
RSPPSPPSSRPPRPSRSRSRPPPSPRRSSPPP
RPRPPRSRRSPRPRRPSRSRRPSSSRPSPRRR
RPRPRPRRRSPSPPRSSRPPPPSRPPRPSPSP
SRRPRPRSSSSSRRPSRSRPPSPRSPRSPRSS
RSSRPSSSPSRSPSRRSSSPPPRPRPPRSSSR
SPSSRPRRSRPRPPSRRSPRPPPSPRPSPSRP
RRPPSRPSRRRSRPSRPSRPPRPRRSSPRSRP
RPPSRRPSSSPPPRSPRSPPRRRRPPSSPPRR
SRSRRRSPSSPRRSPPSSSRPRPSSPSSPPPS
SSSPRSSRSRRSPPRSPPPRPSPPRRPSPRPS
RRRSSPPSRSPPPRRRPRPPPSRPPPRRRSSS
RSRSRSPRSPPSRPSSSSRSPRPPSPRSPPRR
RRPRPPSRSSPPRRSSRPRRPSSPSPRSPSPR
SSRPSSPPRPPSRSRSRRRPSSRSPPRSSRPR
RSRPRPSPRPPSPRPRSPRSSPPPSPRPRSRP
SPSPRRSPPSPRPPSRSSSSPSRPSPSRPPPP
SPSPSRPSRRSRPRRSRRRPSSSRPPSPRPRS
SPSRRPPPPSRSSRSSPPPPSSSSPRSSSRPS
PPRSPRRRPRSPPSRSPSSPSSPSRRSPPPSP
RSPRPSSRPPSSPRSRSRSRSPPPPSRSSPRP
PRRRSSPSRRPRSSPRPPPRPPRSRSRSSRRP
SSPSPRSPSRSSSRPPSRPRSSRPPPRSSPRR
RRSRPRRSRRSSPSSPRRPSPRPSSRPPPRSP
RSPPSRPRSRRRRRPRSSRRSRRSSPSSPSRP
RRSRPPSRRSSPRPSSRPPRPPSPSRSPSSPS
RSPPRSPRSPRRRRRPSRPSSSRPSRPPRPRP
PRPPRRSSSSSSSSSRSSSRPRSSRRPSSRRS
PRRPSPPSSRSPSRRSRSPPRSSRPPRPSRSP
SPRRRRPRSPRSRSRRSPPSRSPSRSSSSPSR
PSPRRRRPPSRSPRRRPSRSPPSSPPSSRRSP
PSSRSPSRPSSPPSSSSRSRPPSRPPRPRSPP
PSPRPSRPRPRRPSPSPRRSSSPSSRPRRRRR
PRPRSPPSRRSPSPSPSSPRSPPPSSSPSRRR
PRSSSSSSSPPPPPPRPRRPSRPRRRSSRRPS
PSPRPPRSRRSSRSPRPRSRPRPRPPSSRSRR
RSPRRRPPPRPPPSPSPPRRPSPRRRSPPPRR
PRPSPSSRSSRRRRRPRRSRRRSSPSPRRRRR
SRPSSPSPSPRSRRRRPRRSRSPSPSRSRRSP
PSSPRRSRSSRSRPPPRSSRSPPPSSPSSSRP
SRSPRPSRRSSSRRRRPRRPRSPRRRPRPPSP
PSPSRPPRRPPRPPSSRRPPPSPSSRRRPRPR
SSRSSRSPPSSRPRPSSSPSPSRRPRSRPSSR
PRRPPPRSPRPRPSRSPRRSPRSPSRRPRSPR
PRSRPRRPSPSPSRRRPSSPPRSPSRSSSRRS
PSRPPSSRPRSPPRRPSSSSSSSRPSRRSPSS
RRRSPPPSRRRPPRRSRRSSSRPSSSSSPRPS
PPPSPRSSRPSPPSRPRSPRRSSRSRPSPPRS
RPSPRSPRRRPRSRPSRPPPPPPSRPRRPRSP
PSPRRPRPSRSSPSSPPPPPSSRRSPRSSPRP
SRPRRRSPSPSSPSPPSRRRPPRRPPSPRSSP
SSSSSRRRPPPSPRRRPPPPPRPSRRRRSRSP
SRPPRPPPRRPRSPSSPRPRPRPPRRSRRSRP
PRRPPSPPRPPSSRRSPRSPRSPPPPPSSRSR
RPSSPSRRSPPRPRRPPSPSSPPRRSPSSRRS
RRSRRSPSSRSRSSRRPSRSRPRRSRPRPSPR
RRRRPSSPSSSSRPSSRSSPPRRRRSSPRRSR
PRPPSRPPRSSSRRRPRRPPSRSSPPRRPPPR
RPRPPPRRSPRRSRSRPSSRRRSRPPRRSRPR
PSPSSRRRRPRPSSRPPSSPPSPPPPRRSPRR
