SPPRSSPP
RSPPPPSP
RSSPSRPP
SRRSRPPP
PPRRRSSR
PSRSRRSP
RRPRRRSR
SSPSSRRP
SRSPRPPP
RRPPSSRR
SRRSPPRR
SRRPPRPP
SPRRSSSR
SPPSSSSS
RPPSPPSS
SSPRSPSR
PPPPRSRP
SSPPRRRS
PPRPSRSR
RPSPSPPR
SPSSPSRP
PRSPPPPR
RPPPRSSS
SRPRSSSR
RPSPPPSR
PPSSPPRP
PSSRRSPR
PRRSSPPR
SRSRPRRR
RPPSSRRR
SPRPPSSP
RPRSSSPR
PPSPPPPP
PSSSSPRS
RRPPPRRP
RSPSRRSS
PPPRPSSR
PSPPSPRS
PSSRRRRR
PSRSRPPS
SRPRSSRP
SSRPPRSP
RRSPPSRP
RSRRSPPS
SRRPRRPR
SSSRPPRR
SSRRPPSP
SSRPRSSR
RRSPRPPP
PSRRPSSR
