SRSPRRRRSSSPPPSSSSSRPRSSRSSPPRSR
PSSRSSPPSRPPRPSSPPPRSSRSPPRPRPSP
SRRPPSRSRPPRRPSSSRSRSPSSRRSPSRRS
RPRRPPSSPPPPSSSPPRRPPSPPSRRRRSRR
SSSPPRRRRRPPSRRSSSPRPPSSPRSRSPSP
PRRSSSPSRPSSPRPRRSRPRPRPSPPRRSSR
SSPSPRRPPRRPRRSSRRPRRSPRPSRSPRPS
PRPRSSSRSPPRSPSPSRSRPPPSRSPPSRSS
SPPPRRPSSPSRSPPRSRSPSSSPPSSRPRSP
RSSPPRPRSRPRRSPPPRSRSSRPSRPSPSPP
RRPPPPPSSPRSPPSSRSSPRPRSPSSPSSPP
SPPSPPSSSSPPRRRRSPPPRRSRRSPPRRPP
PPRSSPSPRRSPSSPRPSRPRSPRRSRSRSRR
RRPRRRPSSPSRSPPPSRRPRPSPSPPSPPPP
RPSRPSPPPPRPPSRRPSSPSRPSRPSSRSSR
PRSSSSSPPRRPPRSPRSPRPPSPPPRSPSSP
RSPRPPSSSSRRSRSPSPPRPRPRPPRPRSSP
PRPPRSSSPRRRSSSSSRPPRPPPSSRSPPRP
SPSPPRPSRRPSRPPRSRRSSRRSRPRRSSSP
SPPPSRRPSRSPRRPSPPRRRSRSPRPPSPPP
PSRRSPSRPRSPSRRSPRSRSRRSRSRSPPSR
PRSRRRRRRPSRSSSSSRSSSPRRRPSPSRPR
SPSRPSPPPSRSRSSRSRSPSPSSPSPRPPSS
RSRRSSSRRSSSSRRRRRRPSPSSRRSRSSRR
SSPPPRRSRPRRSSPPRSSRRPPSSRSSPPRS
SPPRPPPSSRPPRPPSSRSPSSSSRRSPSPSR
RSSPRRRRRPSSRRSPSRSPRRSPPRPRRRPR
RPPSSSSSRSSRPPPPRPSPRSSSPSPRSRSP
PPRRRRPPRRPPRPRRPPSRSRPSRRRRPRPR
RRSRPSSPPPPSRRRRRSSRRSSSRSPPRSSP
PSPRRSSRSRRRRRRPSPRRSRPRSPRSRPPR
PRPPPPRSPSPSPSRRSPSPPPPRSPPSRRPR
SRRPPSRRPRPRPPSPSSPRSSRSSRRPRSPS
RSSPRPRSSPPPPPSSSRPPRSSRSSSRPRSP
SPSRSPSPRSPRSRPPPPPSSSRRSPRPPRPS
RRPRPRRSRSRSRRPSSPPPRRSSRRRRSPPR
PPPPRSRSSRPPSRRRSSRRSPRRPPPPSRPS
PSSRRRSSRPRSSPRSPPPPPSRRRRPPPRSP
SPRSRRSPRSPPRRSSPRRSPSRPSSSPPRSR
RRPRPPSRSPSPSPRRSSPSSPPSPSSPSSRR
RSRPSRRPRSSPSPSPPRRPRPRRPRRPSPPS
RRRRRSRPPPSRPPSPPRRRSSRSSSRPRSSP
SRSSRSPSSRRPSRRRPPPRSSRRPPPSRRPS
PSPPRRRSSSRRSRRRRPSRRRRSPSPRRPPP
RSSRPSRSRPPPRRRRSSRRRSPRRRRSRSPS
SSRSPPPPSRRPPSRSRRSPSPPSSRRRSPPP
RPSRPRRPSPPSSPPPRSPPPRPSSPPSRPPS
PPSPSSSRSRRRSPSSPRSRSRSSPRSSPSSR
SRSSSRRRRSPSSRRRSPSSPRSPPPRRSSRS
PRSRRSSSRRPSRRPPRPSRRSSRRSPPRPPR
RRPSPSPSPPPSPPPRSSPSRRPPPSRPPRRR
RPRSPPSPRPRPRSRPSSSSRPRPSRPPSPPS
SRPRPPRRRSSSRSSSPPSRPRSPPPPPSPPP
RPPRRSRPSRSRSPRSPRPPSPRSPSSRSPRR
PPPSPRRPSPSPRSSPSPSRSPRSPSPSPPSS
PRSRSSRPSPSPSPRPPRPSPRSPRRSRPSRS
PPRRRSRPSRSPRSRSSSPSSRSRSPPRRPRP
RSRRRSPPPRPRPPPPPSPPPRPPSPPSRSSP
PRSPPPPPPRRSPRSSSRSPPSRRPPSSPPPR
PSRRSSRSPPPRSRPSRRPPPRRRSSRSPPRS
SRRSPPSSPSRRSSSRPRSPSPPRPSPPSPPS
RPPRRSRPRSPSRSSPPPSRPRSSRPPRPRRP
RPSSSRRRSPSPSPSSSPRSRRSPSRSPRSRP
PRPRRPSPSSSPRRPSRSSPPSRSSRPRPPPR
SRRPRSPSRSRSSRRRPSSSSRRPPRSRPRRP
PPPSRSPRSRSSRRSPSRPSSPRSPRRPPPPR
SRRPSSSRPPRSRRSRSPPSSPPPPPPRPRPS
SRPPSRSPPPPSPSPPRSPRSSPRSPPRRPSS
RRRSSPRPSRSPPSSRSRPRRSPRRPRPPRRS
RRSRPSSPPRRRPSRPSRPPRPRSRRRSPPPR
SPPRRPPSRSPPSSRRSPRSSSSPSPSSPSRR
RRPRPRPPSPPSRRSRSRPPPPPRSPRRPRSR
RRSSSRSRRPPPSSPRSSRSRSSRPSPSRRPS
SRRPRSPPRSRPSSRSRSPSPSSSRRSPRPPS
PPPSSSRPRSRSRSPRRRRPRPSPRPSRPRPR
RSRSRRRSSPSPRSRPPSPRSSPSRPPPPRPP
PSSSRRRSPPRSRPSPPSRPSSSSSSPSSRPS
SSSSPPRRRSSSPSPPRRPRPRRPRSRRPPPP
SPSRSPRPSRRPRPSPRSPRRSSSSPSRSSRP
RRRRSPRPSRRSPRSRPRSRPPSSRPSRRSSR
PSRSSSSRRRSRPRPSRSRSSRPRRPRSPSRR
RPPSRSSRRRSPSRPPPRSPPSPRPPPRSRSR
PSSRPRPRRPPSRSRRRPRPPSRSRPSRPPPS
SRRPSRSPSRSPSRSSSRPSPPPSSRSRPRPR
RSRSSSRRPRRPPPRRPSRPPRRRPPRSPRPS
PPSSSRRSPPPSPSRSPRPRPPPSPRPRRPPR
RRRPSSPRSPPSSPRSPRSSPPSSPRRSPSSS
RPRRRSRPSRRSRPRRPRSPPSRSRPPRPRRR
PPRPRRPRSSRRRSPSPSPRSSRPPSPPSPRR
PSPPSRPPSSSRRSRSPPPSPPRSSSSSPRSR
RSPRRPPRSRRSRPRSSPPSRPRPRSPPPRSP
RSPPSRSPSSPSRPRRRRSPRPPPPSRRSPPS
PRSPPSSRRPPRRSSSSPSRSRSPSPSPPPRS
RSPSRPRPPRRRRPPRRPPRPSSPPSSPPSPR
RSSSPRPRRSRSRRRRRPRPSRPPRPPPSRRP
PSPPPSRPPRRPSPSRRPSRPSSRSPSRSRRS
RPRRRRSPSRSSPRPPRSSPPRRRSRRRSSPP
SRPPRPPPPPPRRRPSPSPPPRPRPSRRRSSS
PRRPSPSRSPPRPSRRPSRRRSRSRSRRSRSR
RSRRRSSSRPRRPPSRRPPSSPSRPRSPSRSS
