RPRSRPSS
SPSRPPPS
PPRSPSPR
RRSRPPRP
RPPSSRRR
PRSSSRSP
SPRSPSRR
SRRSPPRS
SPPRSSSS
SPSRRPSP
SSPSRRPP
SPSRSRRR
SRSPSPPP
SSRRRSSS
RSPRSRPS
PSRSPRPP
RSSSSRRR
SSSSSRRS
PSSSSSPR
RPRPPSRS
SPPPRSPS
RRSRRSPS
PRSPSSPS
RSPRRRRP
PSRPRRPP
PPSPRSRP
PSSRRPPR
PPRPPSPR
PRSSPRSS
SPSPRPRS
SRSPSRSP
PRPSRPSP
PPPRSSSR
SPRPPSRS
RPPRPSSP
SSRPPSSR
PPPPPPRR
PSPSRPRS
PSPSSRPS
RSRSPRPS
SSPPPSPS
SSRSRPPP
RRRSRRSR
SSRPSPSS
SPRRPPRP
RSRPRSPR
SRRPPSRS
SPRRRRSP
SPRPRSPR
PPPRSPPS
