YRPRPPPRRPPSRPRRRPRRRRPRPRRRPPYR
YYYRYLRRYLRYRRYRYLSLYLYRYRLYYYYR
RRRLRRPRPPPPRPRLSPPRRPRRRRRRPPPR
LYLSRPRRRRRRRRRPRRRRRRPRRRRRRRRR
RRRRRRRRRRRRRPRRRYLYLYSLLYYRYRRR
RPRPPRPPRPRRPYRRRRPRPRRRRRRPPSYL
PPRRPPPPPPPSPRRRRRRRRPPRRSSSSYPY
SLYLLYRYYRYLYYRYRRRYRYYLYYRRLRYY
PPPSPPPPPPPRRRRRRRRRRSRRRRRRRRPR
RRRRYRRRYRRRRYLLSPYLLYYRYRYLRYYR
LPPPPPPPPPPRRRRRSSSSSSSSSSSSSSSS
YRYYPRYRYPSPRPRYRYRYYRYYPPLRYYPY
RRYRRPRYPRLYLSSYPPYRYYRRRPRYYPPS
LLSPYYPRPPRYRRPYRYRPYSYRYRPYRRYY
RPPRRPRRRPPPRRPRPRRRPRPYRRRPRPSP
LYSLLLPSRYPPRRRRSSSSLSSSLPSYSPYY
RPRPRPSPPPPPRPRRPRRRRRRRRRRRLSSP
PPPPPPPSPPPRPPPPPPPPPPPPPPPPPPPY
YYYRLYYYYYYYYYRLLYYYYYRRSLLYLYYR
YYYYRRRRLRRYRRRPLRRRRPRRPSPRLYYR
LRPRPPRPPPYPPRRRRYRRRRPPPRRRPSPR
LSYLPYRRSYRRRPRRSRRRPRRSRRRRRRRR
PPPSPPPPPPRRRRRRRRRRRRRRRRRRPRRS
YLSLRRYPRYYLRYRYRYYRYYYYYYRRYRYL
PYPYRSSSSSSSSYPYYYYYYYYYYYYYYYPY
PPPPPPPPPPYPPPPPPPPRPPYPRRRPPSRP
RRRRRRRRRRRRRRRPRRRPRRRRLYRYLYSL
YRPRSLYLRRPRYRRYRRRRRRRRRRRYPRRY
RYYLLSLLPRRLRRRRRYPRRRRRRRRRRRRL
PPPRPPPPPSPPPRPRSRRRSRRRPRSRRRSS
LSLLRYLLRRRRRPRLRLPRLRRPLRLRRSRR
YSRPPPPYRPRRRRRSSSSSLSSSSYPYRYYY
PYPPYPSPPYRPRYRPRRPRRRRPRRYYRPRP
RRYYYRSRRRYRYYLYRYLLSSLYRRRRRRPR
SSLYLYYRYRYLRYRLRRPRRYYYYYRRYYYR
RPPPPPPPPPPPPPPPPPPPPPRRPRRRSSSS
PSPYYPPPPPPYPPYRPRRPYYRYPYPYYYYL
LLLLPPPPSPPPPPPPPPPPPPPPRRRRSPSS
RPSPPPRPRPPRPYRRRRRPPRPRRRRRRPPP
RRRRYRRPRRRRRRRRRRRRRPRRSLYLYRYL
RYRRRRRRYRLYYYRRYLRYLSYLRPLRYRYR
LLLLLPPPPPPPSPPPPPPPPPPPPPPRRSSP
LSPPPPSPPPPPPPPPPSRRRRRPSPSSYYYY
LLPPPPPPPYPPPPPPPRRSSSSSPYYYYYYY
PYLSRSPRLRRPRRRRLRRRRLRRRRRRPRYP
LLLLPPPPPPPPSPPPPPPPPPPPPPRRPYYY
SLRPPPRPPPSPPRRRPRRRRRRRRRRRPRPL
LLLLLLLLLLLLYPPPPPRRRRRRSSSSSSSL
YLPPPPPPPPPPPPPPPPPPPPPPPRSSSSLY
PPPPPPPPPPPPPPPPPPPPPPSPPPRRPYYY
