RRRPPRPPPPRRPRRRRRRRRRPRPPRPRPPYPRRRPPRRRPRRRRRRRRRRRRRRRRRPPRPPPPRPRRPRRPRRYRRRRRPRRRRRPSPPPRRRRRPRRPRRPRRPRRPYRRRRRRRPRRRRPRRR
LLLLLLLLLLLLLLLLLSLPPPPPPPPYPPPPPPPPPRRYRRRRRRRRRRRRRRRRRRRRRRRRRRRRRRRRRRRRRRRRRRRRRRRRRRRRRRRRRRLYYYYYYYPYYYYYYYYYYYYYYYYYYYYR
LLLLLLLPPPPPPPPPPSPPPPPPPPPPPPPPPPPPPPPPPPPPPPPPPPPPPPPPPPRPPPPPPPPPPPPPPPPPPPPPPPPPPPPPPPPPPPPPPPPPPRRRPRRRRRRRRRRRRRPSSSSSSSYY
SPPPPPRPPPPPPPYPPRRRRRRRRRRRYRYRRRRRRRRRRRRRRRRRYRRPYRRRSRRRRRRRRRRRRYRRRRYRRPRSSSSSSSSSSSSSSRSSRYRRYYYYYRYYRYYYYYRRYYYYLYYYYYYY
YLRRYSRRYRLLYYRLRRRRRLPRLLSLLLYRRRRRRRYLYRRRRRLYRRRRRRYRRYLLLLRYRRRRRLLLRRRRLRRRRRRLRRLRRYYRRLYRRYRRRRLRLLRSRRRRRRRRRYLRRYRLLLRY
RRRRYYPYRRRRRYRPPYYYRYRRPPPPRRRYRRRRRRRYRRYRYRRRYRRYYRYYPYRRRRRRPRRRYYRRRRRRRRYRYRYYRRYYYRPYPRRYYPRRPSYPRYYRRPYRRRRRRRYYYYYRRPRR
LLRPPPRPYPPPPRPPPPPPPPPRRPRPRPRPPPPRRRRRRRRRPRRRPRRRRRRRRRRRRRPRRRRRRRRRRRRRRRRRRRRRRRRRRRRRPRRRRRRRRRRPRRRRRRRRRRRRRRRPRRPRPRSP
LYPPPPPRPPPPRPPPPPPPPPPPPPPSPYPPPPPPPPPPPPPRRRRRRRPRRYRRRRRRRRPYRRRYRRRRRRRYRRRRSPSSYYYYRRYRYLYYYYYYYYYYYYYYYYYYYYPYYYYYYYYYYRYY
RRRRRRPRRRRRPRPRPRRRRRRRRRRRRRRRRRRRRRRRRPRRRRRRRRRRRRRRRRPRRRRYRPPRRRRPPPPRRRRRRRRRRRRRRPRRRRPRRRPRRRRRRRRRRRRRPRRRRRRRRRPRRPSP
LLLLLLLLLLLLLLLLLLLLLYLLPPPPRRRRSSSSSSSSSSSSSSSSSSSSSSSSSSSSSSSSSSSSSSSSYYYYYYYYYYYYYYYYYYYYYYLYYYYYYYYYYYYYYYYYYYYYYYYYYYYYYYYY
RRYRLYYRLYSLRYYLLYYRRRYRYYRRRRRRRRRRRRRRYRRRRRPRRRRRRRRRYRRRRRRRRRRRLRRRRRRRRYRRRRPRRRRRRRRRRRRRRYRRRRRRRRRRRRRRRRRRRRRRRRRRRRRR
RRRRRRRRYRRRRYRRRRRRRRRRRRRRRRRRRRRRRRRRRRRRRPRRRRRYRYRYRRRRRYRRRSRRRRRRSRRRRRRRRRRRRRPRRYRRRRRRRRRRYYRPSSSSSSSSRRRYYYRRRRYYYPYR
LLLRLPPPPPPPPPPPPPPPPPPPPPPPPPPPPPPSPPPRPPPPPPPPPPPRPPPPPPPPPRPPRRRRRRRLRRRRPRPRRRRRRRRRRRRRRYRRRRPRRSPSSSSYYYYYYYYYYYYYYYRYYYYY
YRYYYYYYYYRYRYYYRYYYYYRYYYYYRYYYRYYYYYYRYYYYYYYYRYYLYRYRYYRYYYYYYYYRYYYRYYYLYYYYLYYYLSLYYYPYYYYYYRRYYYYYYYYRRYLYYYYYYYYYYYRRYYYY
LLSLLLLLLLRRRPRRPPPPPPRRRRRPPRRRRPRLPPLPPPYRPRLRPRPRRRRRRRRPRRRRRRRRRRRRPLYSRPRPPRRPRRRRRRRLRRRRRLYRRYRRRRRRRRRRSRPRRRSRRLYPRRYY
SSLLLLLLLLLLYRRLLLLLLLLLRLLLYRRRLRLRRLRPRRLRLLRRLRLRLRLRRRRRSRRRLRRRLSRLRLRRRLYSLRLRLRRLRLRRRRRRRRYRLLRRRLLLRRRLLLRYLLLLRLRLRLRY
PPPPPPPPPSPRPRYPPPRPYPPPRRRRPRRPRRRRRRRRPRRRRRRRRRRRRRRRRPRRRRRRRRRRRRRRRRRRRRPRRRRRRRRRRRRRYRRRRRRRRRRRRRRRPSYYYRYYYYYYYYYRYYRY
YLLLLLLPPPRPPPPPPPPRPPPPPPPPPPPPPPPPPPPPPPPPPPPPPPPPPPPPPPPPPPRRRRRRRRRRRRRRRPRRRRRRPRRRSSSSSSSSYYYYYYYYYYYYLYYYYYYYYYYYYYYYYYYY
LLLLLLLLLLLLLLLLLLLLLRPPPSPPPPPPPPPPPPPPPPPPPPPRPPPPRPRRRRRRRRRRRRRRRPRRRRRRRRRRRRRRRRRRRRRRRRRRRRRRRRRRRRRRRRRRRRRRRRSSSSSSSSSP
PPLLLYLLLLLLLLLLLLPPPPPPPPPPPPPPPPLPPPPYPPPPPPPPPPPPPPLPPPRPPPPPPPPPPPPPPPPPPPRPYPPPPPLPLPPPPPPPPPPPPPPPPPPRRPRRPSSSYPYYYYYYYPLY
LYYRLYSLRYRRRYLYRYLYRYRRRRRRRRRYRRRRRRYRRRYRRRRRRRRYRRRRYRLYYRRRRRRYYRRRRRRRYRRLYYRRRRRRYLYRRRRYRRRRRRRYRYRYRRRRRRRRYRRRRRRRRRRR
RYPPPRSPPRRRRRRRRRRRRPPRRRRRRRRRRRRRRRRRRRPRRRRRRRRRRRRRRRYRRRRRRRRRRRRYRRPRRRRRRYRRRRRRRRRRRRRRRRRRRRRRRRRRRRRRRRRPYYYYYYRRYRYR
PPPPPPPPPPPPPPPPPPPPPPPPPPPPPPPPPPPPPPPPPPPPPPPPPPPPPPSPPPPPPPPPPPPPPPPPPPPPPPPPPPPPPPPPPRRRRRRYRRRRRRRRRRRRRRRRRRRRPRYYYYYYYYYY
RRRYYRPPRRRPSPPRRRRYRRYRRRRYPRRRRYRRRRYYRRRRPRRPRRRPRYSRYRRRRRYRRLRRRRPYRRRRRRRPRYYRRRPYRPRPRRRRRRRRRRRSRSPRRPRRRYYYPPYRRYYYRPRR
LLLLLLLPLSPPPPPPPPPPPPPPPPPPPPPPPPPPPPPPPPPPPPPPPPPPPPPPPPPPPLPPPPPPPPRRRSYSSSSSSSSLSSSSSYYYYYYYYYYYYYYYYYYYYYSYYYYYYYYYYYYYYYYY
PPRPSPSPPPPRPRPPRRRRRRRRRRRRRRPRRRRRPRRRRRRRYRRRRRRRRRRSSRRRRRRRRRRYRRRRRRRPRYRRRRRRRRRRRRRRRRRRYRRRRRRRRRRRRSPSPSSSRSRSYRRYRYYR
RRRPRPPSRRRRRRRPRRRRYRRRRRRRRRPRRRRRRRRRRRYRRRRRRYRRRRRRRRRRRRRPRRRRRRRRRRRRRPRYRRRRRRPRRRRRRYRRRRRRRRRRRRRRRRRRRRRRRRRRRRYRRRRR
LLPLLLLLLLLLLPPPPPPPPPPPPPPPPPPPPPLPPPPPPPPPPPSPPPPPPPPPPPPPPPPPPPPPPPPPPPPPPPPPPPPPPPPPPPPPPPPPPPPPPPPPRRRRRRRRRRRRRRRRSSSSSPSS
SLLLLLLLLLLLLPLLLLLPPPPYPPLPPYPPPPRRRRRRRRPRRRRRRRRRRRRRRRRRRRRRRRRRSSSYLSSSSYYYYYYYYYYYYYYYPYYYYYYYYYYYYYYYYYSYYYYYYYYRYYYYYYYY
PLLSSSSLYSLYLSYSLYPSLPPYPPLPRRRRYRSRRSSSSYSLPYYSSSSSSSSSSSRLLSSSSSSSLSSSSSSSSSLSSPSSSSSSSSSSSSSSPSLSSLSSSSSSYYLRYLYYYSSYYYLSYSSY
PPRRRPSPPRRRRRRRPRRRRRRRRRRRRRRRRRRRRRRRRRRRRRRRRRPRRRRRRRRRRRRRPRRRRRRRRRRRRRRRRRRRRRRRRRRRRRRRRRRRRRRRPRPRRRRRRRRRRRRRRRRRRRRY
LLLLRLLLRLLLLLRRPPPPPPPRRRPPPYPPPPPPPSRPPPPPRSRRPRRRRRRLRRRRRRRRRRRRRRRRRRRRRRRRPSRRRRRRRRRRRRRRRRRRRRRPRRRRRRPRRLRPRRRLPRSSSPSR
SLRLRRRRRRRRRRPRRRRRRRLRRRSRRRRRRRRRRRRRRRRRRRRRRRRRRRRRYRRRSYRRRRRRRRRRRRRRRPRRRRYRRRRRRRRRRRRLRPSYRYLRRRRRRRRRSSSSSSSLRRRRRPRR
LPLPPYPPPSPPPPPPPPLPPPYPPPPPYYRPPPPPPPPPPPPYYPPPPPPPPPPYYPYPPPPPYPPPPPRRRRRRRPRRRRRPPPYYYPYPYYYYYYYYLYPRYYYYYPYYYPYYYYYYYYPPYYYY
RPPPPPPPRPYRPPPPPPRPRPPPPPPPPPPRPPPPPPRRRRRPRPRRRPPRPRRPPPPPPPPRPRSPRRRPRPRRRPRPPRRPPRRRRRPRRRPRRRRPRPRPRPRRRRRPRPRRPRRRRPRRRRPY
RPRPRRRPSPRPPRRPLRPRPPPRPPRRRRRRRPRRRPRRRPRRPPRPPRYPRPRRPRRLRRRRPPPRRPPRPRYRRRRRYPPPRRRPRRRRPPRRYRRRRPRRRRRRRPRRRRRPRPRRRRRRRRRP
LLRLRLPRRLLLRLLLLPLLLLLPRPPPPPPPPPRPLPPPPPPPPPPPPPPPSPPPLRPPPPPPLRRLRRLRRRYRLRRRRRRYRPRRRRRRRRRPRRPRRRYRRRRRRRRRRRRRRSSSSSPRRLYY
LLLLLLLLLLPPPPPPPPPPPPPPPPPPPPPPPPPPPPPPPPPPPPPPPPPPPPPPPPPPPPPPPPPPPPPPRRRRRRRRSSSSSSSSSSSSSSSSSSSSSSSSSSSSSSSSSSSSSSSSSSSSSSSS
PYPSYPYYPYYRYYYPYYYYYYYYYYRYPYYYYYPYYYYPYPYYYYYRPYYYRYRYPYYYYPPYYPYRYPYRRYYYYYYYYYPYPRYYYPYYYRYYYPYPYYYYPYYYYPYRYYRYPYYYPYRPYPYY
LLSLPPPPPPYRPPPPPPPRPPPRRRRRRRRRRRRRRRRRRRRRRRRRRRRRRPRRRRRRRRRRRRRRRRRRRRRRPRRRRRRRRRRRRRRRRRRRRRRRRRRRRRRSLSSSSSSSSSSSSYYYPYYY
LLPPPPPPPPPPPPPPPPPPPPPPPPPPPPPPPPPPPPPPPPPPPPSPPPPPPPPPPPPPPPPPPPPPPPPPPPPPPPPPPPPPPPPPPPPPPPPPRRRRRRRRRRRRRRRRRRRRPSSYYYYYYYYY
SLLLLLYSLRYSLLLLLSLLRLLLLSLRYRRLYRRRRSLYRRRRRRRYRRRYYYSSYRYLYRLSSSLSSLSSSYLYYYYYYSSLYLYYYYYYYYYYYYYYYYYYYLYSYYYYYRYYYRSYYYYYRYYL
LLLLLLSLPPPPPPPPPPPPPPPRRPPPPPRRRRRRRRRRRRRRRPRRRRRRRRRRRRRRRRRRRRRRRRRRRRRRRPRRRRRRRRRRRRRRRRRRRRRRRRRRRRRRRRRRRRRRRRRRRSLSSSSS
LLLLLLLLLLLLLLLLLLLLLLLLLLLLLLLLLLLLLLLLLLLLLLLLLLLSLLPPPPPPPPPPPPPPPPPPPRRRRRRRRRRRRRSSSSSSSSSSSSSSSSSSSSSSSSSSSSSSSSSSSSLSSSSY
LLLLLLPPPPPPPPPPYPPSPPPPPPPPPPPPPPPPPPPPPPPPPPPPPPPPPPPPPPPPPPPPPPPPPRPPPPPPPPPPPPPPPPPRRRRRRRPYRRRRSPSYYYYRYYYYYYYYYYYYYPYYYYYY
YLYYYPYLLYLLLPYRLYLPPPPYLYLPPYPYPPPPPYSSPLLYYYYPRSPPSSYSYPYYYYPSYYYSYYYYRYPYYYPYYYYYLYYPYYYYLYYPYPYLLPYYYYYSSYLYYLYYPYYYYYPYYYYY
PPPSRPRPRPPRRPPPPPPRPPPPRPPPRRYPPYRRRRRRRRRPRPRRRRRRRRRRRRRRRRRPPRRRSRRRRRRRRRRRPPRPRRRRPRYRRRRYRRRRPRRPRYRRRRSPSSPYPRYRYRYYYYRY
LLPPPPPYPPPPPRSPPPPPPPPPPPPRPPRRRRRRRRRYRRRRRRRRRRYRPRRRRRYRRRRPRRRRRRRRPRRYRRRRRRRRRYRYRYRSPYYRYRYRYYRYRYYYRYYYYYYYYYYYRYYYRYYY
RLLLPPRPRPPPPPPPPSRPPPPRRRRRRPRRPRRRPRRRRRRRRRRRRRYRRRPRYRRRRRRRRRRRRRRRPRRRRYRRRRRRRRRRRRRRRRRRRRLRRRRRRRPRRRRRRRRSSSSSYYYRRYYR
LLPPPPPPPPPPPPPPPPRPPRPPYRPPPPPPPPPPPPPPPPRPPPPPPRRPRPRPPPRRRRRRPPRRYRRRRRRPRRRRRRRRRRRRRRRRRRRRRRRRRRRRPRRPRRRRPRRRRRRRRPSSPYPY
SLLLLRPRPPRSPPPPPYPPPPPRPPPYPPPLPPPPPRRPRYPLPPPPRRRRPRPRRRRRRRRRRYRRYRRRRRRRRRPRRRRRRRRRLRRRRRPRPRRRSLPPYYYYYSYYYPYPYYYYYYYYYYPR
LLLLLLLLLLLLLLLLLLLLLLLLLLLLLLLLLLLLLLLPPPPPPPPPPPPPPPPPPPPPPPPPPPPPPPSPPPPPPPPPPPPPPPPPPPPPPPPPPPRRRRRRRRRRRRSSSSSSSSPSSSYYYYYY
LLPPPPPPPPPPPPPPPPPPPPPPPPPPPPPPPPPPPPPPPPPPPPPPPPPPPPPPPPPPRPPPPPPPRPPPPPPPSPPPPPPPPRRPRRRRRRRRRRRRRRRRPRRRRRRRRRRRRRRRRRRPSSSS
RPPSPPPPPPPPPPPPPSPRRPPPPPPPPSRRRRRRRRRRRRRRRRRRRRRRPRRRRRRRRRRRRRRRRLRRRRRRRRRRRRRRRRRRRPRRRRRRSRRRRRRRRRRRRSRSSPSPSSSSSSRSSSSY
RRRRRPRRRRRRRPSRRRRSRRRRRRRRRLRRRRRRRRRRRRRRRRRRRRRRRRRRRRRRRRRRRRRRRRRRRPRRRRRPRRRSRRRRRRRRRRRRRRRRRPRRRRRRRRRLRRRRRPRPRRPRSSPR
PPPPPPPPPPPPPPPPPPPPPPPPPPPPPPPPPPPSPPPPPPPPPPPPPPPPPPPPPPPPPPPPRYPPPPPPPPRRRRRRRRRRRRRRRRRRRRRRRRPRRRRRRRRRRRRRRRRRRRRRRPSYYYYP
PPPPRPPPPPPRPPPRRPPPPPPRPPPPPPPPSPPPPPPPPPPPPPPRRRRRRYPRRRRRPRRRPPRRRRRRPRRRRRRRRRRYRRRRRRRRSSSSSSSSSSSPSSSSSSSSSSSSSYYYYYYRRYSY
RPRRRPYRRRYYYPYPPYPPPYRPPYRYRRRPRRYPRRPPYRRRYRRPPRPPRRYRRYYRYRLRRPPLRRPYRRRYYRRPRRPPRRRYYRRRRYRRRRRRPRYRPPRRPPRYPRPSRLPRYRRRPPRR
LSRLRLRPRRRRRLRLLRSLRLRSLLRRRLRLSLSRRLPRLLPPRPSPRRPPRLSRRRRRPLLRRRRRLRRRRRLRLLRRLLLRRRRRLLRRRLRRLRLLRRRRRRRRLRRRLRRPLRSRSLLRRRRR
LPPPPPPPPPPPPPPPPPPSPPPPPPPPPPPPPPPPPPPPPPPPPPPPPPPPPPPPPPPPPPPPPPPPPPPPPPPPPPPPPPPPPPPPPPPPPPPPPPPPPPPPPPPPPPPPPPPPPPPPPPPRRRRP
RLPPPPRPPYPYPPPYSPPPPPPPYPRRRRRRRRRYRYRRYRRRRRRRYRRLRRSRRYRRRRRPRRRRRRRRRRRRRRRRRSSSSSRSSSYSSYYPRYPYYYPYYYYYRYRPYYYYYYRYYYYYPYYR
LLLLLLLLLLLLLLLLLPLLLLPLLLLLLLPPPPPPPPPPPPSPPPPPPPPPPLPPPPPPPPPRLPPPPPPPPPPPPPPPPPPPPPPPPPPPPPPPPPPPPPPRRRRPRRRSSSSSSSPSSSYYYYYY
RRRRRYRRRYRRRRRRRRYRYLYRRYRRRRRRYRYRLYYRYLLSYRYLRRRYLYYRRYYRRRRRYYRRRRRRRRRYRYYLRRRRRRRRRRRYRRRYRRRRRYRRRRRRRRRRRRRYRRRRRYLRRRRR
LLPLYPPRPPPPPPPPPPPPPRPPPPPPPPPRPPPPPPPPPPPRPPPPPPPPRPPPPLPPPPRRPPPPPPPPRPRRRRRRRRRRRPRRRRPRPRRRRRRRPRRRPRRRRRRRRRPRPRRRPSSSYPYY
RPPSRRPPPRPRPPPRPPPPPPPRRRRRRRRRPRRRRRRRRPRPRRRRRRRRRRRRRRPRLRPRRRRRRRRRRRRRRRRPRRRRRRRYRRRPRRRRRRPRRRRRRRPRRRRRRRRSRRSRSRSSSYYR
LLLPPPPPPPPPYPPPPPPPPPPPPPPPSPPPPPPPPPPPPPPPPPPPPPPPPPPPPPPPPPPPPPPPRRRRRRRRRRRRRRRRRRRRRSPSSSSSSSSSSYYYYYYYYYYYYYYPYYYYYYYYYYYY
LLLLLLLLLLLLLYLSLLLLLLLLPPPPPPRRRRRRRRRYRRRRRSSSSSSSSSYSLYYYYYYYYYYYYYYYYYYYYYYYYYYYYYYYLYYYYYYYYYYYYYYYYYYYYYYYYYRYYSYYYYYYYYYY
PPPPPPPPPPPPPPPPPPPPPPPSPPPPPPPPPPPPPPPPPPPPPPPPPPPPPPPPPPPPPPPPPPPPPPPPPPPPPPPPRRRRRRRRRRRRRRRRRRRRRRRRRRRRRRRRRRRRRRRRRRRRPSSY
LLLYPPPPPPPPPRPPPPPPPPPPPPPPPPPPPPPPPPPPPSPPPPPPPPRPRRRRRRRRRRRRRRRRRRRRRRRRSSSSSSSSSSSSSSSSSSSSSSSPSSSYYYYYYYYYYYYYYYYYYPYYYYYY
LLLPPPRRPPPPPPPPPRRPPPPPPRRPPPPPPRPRPPPPRPPPPPYRPRRRRRRPPRRRRRRRRRRRRYRRRRRRRRRRRRRRRPRRRRPPRRPRRRPRRRRYRRRRRRRPPRRRRRRRSSRPYYPY
YRRRRRRRRRRRRRRYRRYRRRRRYRRRLLRYRRRRRSRRRRRRRRRRRRRRRRRRRRRRYRRRRRRRRRRRRRRRRRPRRRRRRRRRRRYRRRRRRRRRRRRSRPRRRRRRLSSSRYLYRPRRRRRR
LPPPPPPPPRPPPPSPRPPPYPRRPRPPPPPRRRRRRRRRRRRRRRRRRPRRRRRRRRRRRRRRRRRRRRRRRRRRRRRRPPRRRRPRRRRRRRRRRRRRRRRRRRRPSSPSSSSYYYYYYYYPYYYY
LLLLLLLLLLLSLLLLLLLLLLLLLLLLLPPPPPPPPYPPPPPPPPPPPPPPPPPPPRRRRRRRRRRRRRRRRRRRRRRRSLSSSYYYYYYYYYYYYYYYYYYYYYYYYYYYYYYYYYYYYYYYYYPY
RPLRPLRPRRRRRRPRRRRSYRRPLRRRRPRRYPRRRRRRLYYRRRRYRPRRRRRRRYPRSLPPRRRRRYRRRRPRRPRYRRRRRRRYRRRRYRRPRRRRYRRRPYRLSYRYYRRPYYRRRYRRRRRR
RLPRLRRLLPRRPRRRRPLRRPPPRRLRPRRPRRPRRRPRRYRRRRPRRRYLRRRRRRRRRRRRRRPRRRRYPRRPRPRRRRLRRRRRRPRSYYRRRRRRRPRRRRRRRRRRRRRPRRRPLSPRRPPY
LLLLLLLLLLLLLLLLYPLLLPPPPPPPPPPPPPPLRPPPPPPPPPPPPPPPPPPPPPPPPPRRRRRRRRRPRRRRRRRRSSSSSSSSSSSSSSSSSYYYYYYYYYYYYYYYYYYYYYYYYYYYYYLY
YYRYRYYRYRLYPYYYYRYYYRRRYYRRYRRYYRYYPYYYSLLYYRPRYRYLYYYYRYRYYYYRYYYRYYRYRYYYRRRYYYRYYYYRYYYYRYRYLYRYRRRYRYRLYRLRYYRYRRYYYYYYYYYY
LLLPPPPPPPPPPPPPPPPPPPPPPPPPPPPPPPPPPPPPPPPPPPPPPPPPPPPPPPPPPPPPPPPPPPPSYPPPPPPPPPRRRRRRRRRRRRRRRRRRRRRRRRRRRRRRRRPSSYYYPYYYYYYY
RYRRYRLYLRRRRRYRLYRYRRRYYLLSRYYLRYRRRRRRRRRRRPRRRRRRRRYRRRRRRRYRRRRRRRRRRRRRRRRYRRRRYRRRRRRRRRRRRRRRRRYRRRYRRRRRRRRRRYRRRYYLYRRR
RRRLLRRLRRLRLLSRRRPPLPPPLPPRPPRRRRRRRRRRPRRRRRRYRRRRRPRRRRRLRLRRRPRLRRRSRRRYRRLRYRRYLRRYRRRRRRRRLRRRRRRPPRRRSSSLLYYYRYYRLRYYYRYY
LSLLLLYPPPYPPPPPPPPPRPPYPRRRRRRRRRPRRRRRRRRYRRRRRYRRRRRRRRRRRYRRRRRRRRRRRRRRRRRRRLRRRRRRRRRRRRRRRRRRRRSSSSSSSSSLSSYYYRRYRYPYPRYY
LLLPYLPLLPLYYLLPPYPPPPLPLYYPYPPPPPPRPPPPPPPPPPYPYPPYPYPPPPPRRPRYSSPSYYLPYYYYPPYYYYYPYYLYYYYYYYPYYYYYPYYYYYYYLYYYYYYYYYYLYYYYYYYY
PPPPPRPPPPPPYRRRPPPPPPPPPPRPPPPPPRRRRRRRRRRRRRRRRRRRPRRRRRRRRRPRRRRRYRRRRRRRRPRRRRRRRRPRPRSSSSSSRYYYYYYYYYYYYPYYYYYYYYYYYYYYYYYY
LLPPPPPPPPPPPPPPPPPPRPPPPPPPPPPPPPSPPPPPPPRPPPPPPPPPPPPPPPPPPPPPPPPPPPPPPPRRRRRRRRRPRRRRRRRRRRRRRRRRRRRRRRRRRRRRRRRPRRRRRRPSSSSS
RRPRLSLLPRRRRRRRRRRRRRRRRRPRRRRRRRRRRPRRRRRRRRRRRRRRRRRRRRRRRRRRRRRRRRRRRRRRRRRRRRPRRRRRRRRRRRRRRRRRRRRRRRRRRRRRRRRRRRRRRRRRRRRR
RYLRRRRRRYRRRRRRRYYRRYRRRYYYYRYLLYRYRYYRYYRRYRRRLYYLLSYLYLRYRYRRYRLRYYRYRRYLYYRRYYYRRYYYLYRYYRYRRYYRRYRRRRRYRRRYYRRRRRRRYRYRRRYY
LLLYLLPRYSLRYLPRLLLLLLLSLYYLYLLLLLLLLLLLLYRPPLPPPLRRSLRRRRYRRRRRLRRSYYLRLRRLSSLSRSSYSYRYYPYLYYYSYYRYYYLYYYYYYYYYYYYRYLYLYLYYYYPY
PPPPPPPPPPPPPPPPPPPPPPPPPPPPPPPPRPPPPPPPPPPPPPPPPPPPPPPPPPPPPPPRPPPPPPPPPPPPPPPPSPPPPPPPPPPPPPPPPPPPPPPPPPPPPPRRRRPPRRRRRPRRRRPS
LLPPPPPPPPPPYPPPPPPPPPPPPPPPPPYPPPPRPPPPPPYPPPPPPPPPPPPPPPPPPPPPPPPYPPPPPPPPPPPYPPPPPPPPPPPPPPPPPRRPPSPYYYRYPYPYYYYYYYYYYPYYYYYY
SPRPPPPRRPRRRRYPYYYRRRPRRRPYRRRYRRRRRRRRRRRRPRRRRRRRPRRRRSRPRRRRRRRRRYRRPRYRRRRRYYRRRRRRPRRRRRRRRRYRRPRRRRRRRRPRRRYYYRRYRYRRYRRR
SLLLLLLLLRRPPPPPPPPRRRRRLRRRRRRRRRRRRLRRRRRRRRRRRRRRSRRRRRRRRRPRRRRRRRRRRRRRRRRRRRRRRRRRRRRRRRRRRRRRRRRRRRRRRRPRRRRRSSRSRSYSSSYY
RRRRRRRRRRRRRRRRRRRRRRPRRRRLRRRRRRRLRRRPRRRRRRRRRRRPPRRRRRYRLRRRSPPRRRPPRPRRRRRRRRRRRRRRRRPRRRRRPRRRRRRRRRRRRRRRRRRRRLRPRRRRRRRR
PYRYYRYYPYYSSSSSSSSYYYYYYYYPYYYRYYYYYYYYRYYYYYPYYYYYYYYYYYYYYYYYYYYYYYYYYYYYYYYYYYYYYSYYYYYSYYYYYYYYYYYYYYYYYYYYRYYYYYPYYSYYYYYY
LLLLLLLLLLLLLPPPPPPPPPPPPPPPPPSPPPPPPPPPPPPPPPPPPPPPPPPPPPPPPPPPPPPPPPPPPPPPPPPPPPPPPPRRRRRRRRRRRRRRRRRRSSSSSSSSSPSSSYYYYYYYYYYY
RRPRPRRRRPRRRRRRRRRRRRRRRRRRRRRRRRRRRRRRRRRRRPRRRRRRRRRRRPRRRRYRRRRRRRRPRRRRRRRRRRRRRRRRRRRSRRRRRRRRRRRSRRRRRPRRRRRRRSPRRPRRPSRP
RYYYYYRYYRSPYRYRRRRRRPRSYYRRRYRYRLRRRYYRYRYPYYRRRYLYYYRRRYYLYPSLRRYPYRRRYYRRPYYYLRYYRPRYRYRLYYYYRYYRRRRRRRYYYYRRYRYPYPRYYRLYSYRY
RYRRPRRLRRRRRRRYYRRRRLLRRRRYRRRRRRRYRRRRRRRRSYRPRRRRRRRRYSYRRRRRRYRRRLYRRPPRRRRRPYSPLYLLLRYRYRYLYRYRRRRYRRYLRYYPRLPRRRRRRSLRRRRY
LLLLLLLLLLLLLLLLPPPPPPPPPPPSPPPYPPPPPPPPRPRRRRRRRRRRYRRSRRRRRRRRRRRRRRSSSSSSSSSSSSSPSSSSSPSSSSSSYYYYYYYYYYYYYYYYYYYYYYYYYYYYYPRY
PPRRPPPRPPRPPRPYPRPRPPPPPRSPPPPPPRPPYPPPPRPYPPRPRRRPPRRRRRRRRRRRRRRRPPRRRPRRRRRRRRRYRPRRRRPRPPPRRRPRRRRRRRRPPRRRRRRRRRSSYYPPRYYR
LPLLLLLPPPPPPPPPLPPPPRPPPPPPPPPPPPPPPPPPPPPPPPPPPPPPPPPPPPPPPPPPPPPPPPPPPYPPPPPPPPPPPPPPPPPPPPPPPPPPPPPPPPPPPPPPPPPRRRRRPRSSSSSP
