LLPPPPRPPPPPYPPPPPPPPRPPPPPPPSPPPPPPPRRRRRRRRRRRRRRRRRRRRRRRRPRSRRRRRPRSSSSSSSSSSSSSSSSSSSPSSSSSSRSSSSSSYYPYYYYYYYYYYYYYYYYYYYYY
LLLLLLSLPSPPPPPPPPPPPPSPPPPPPPPRPPPPPPRRRRRRRRRRRRRRRRRRRRRRRRRRRRRRRPRRRRRRRRRRRRRRRRRRRRRRRRRRRRRRRRPSSSSSSSSLSSSPSSSSSSSSYYYY
LLPPPPPPPPPPPPPPRPPRRPPPPRPPRRPPPPPRPPPPPPPSRPPPPPPRRRRRRPRPRRRRRRRRRRRRRRPRRRRRRRRRRRRRPRRRRRRRPRRRRRRRPRPRRRRRRRRRRRRRPSSSSPSY
LLLLLLLLLLLSLLLPPPPPPPPPPPPPPPPPPPPPPPPPPPPPPPPPPPPPPPPPPPPPPPPPPPRRRRRRRRRRRRRRRRRRRRSSSSSYSSSSSSSSSSLSSSSSSSSSSSYYYYYYYYSYYYYY
LLLLLLLPPPPPPPPPPPPPPSPPPPPPPPPPPPPPPPPPPPPPPPPPPPPPPPRPPPPPPPPPPPPPPPPPPPPPPRRRRRRRRRRRRRRRRRRRRRRRRRRRRRRRRRRRPSSPSSSSSSYYYYYY
LLLLLLLLLLLLPLLPSLLLLLLPLPPPPPPPPPPPLRPPPPLPPPPPPPPPPPPPPPPPPPPPPPPPPPPPPPPPPSPPPPPPRPPRRRRSRRRRRRRRRRRRLRRRRRPRRRRSRSPSSLSSSSSS
RRRYRRRRRRRRRRRRSRRRRRRRRRRRRYRYRRRRRRPRRRRRPPRRRRRYRRPRRRRYYRRRRRRRRRRRRRPRRRRRRRRRRRRRRYRRRRRRRRRLRRRPRRRRRYRRYPRRSSPRRYRRRPRR
LLPPPPPPPPPPPPPPPPPPPPPPPPPPPPPPPPPPPPPPPPPPPPPPPPPPPPPPPPPPPPPPSPPPPPPPPPPPPPPPPRRRRRRRRRRRRRRRRRRRRRRRRRRRRRRPSSSSSSSSSSSSSSSS
LLLLLLLLPLLPLLPPPPPPPPPPPLPPPPPPPPYPPPPPPPPPPPPPPSPPYPPPPRPPPPPPPPPPPPPPPPPPPPLPPPPPPRYRPRRRRRPRRRRRRRRRRRRSPSPRYYYYYYYYYYYYYYRY
PPPPRPPPPPPPYYPPPPPSRPPPPYPRRRRRRRRRRRRRRRRRRRRRRRRRRRPRRRRRRRRRRRYRRRRRRRRRRRRRYRYRRRRRRRRRRYRRPRRRRRRRRPRYPPYYYYRYRYPYYYYYYYRY
LLLLLLLLLLLLLLLLLLLLLLLLLLLLLLLPPPPPPPYPPPPPPPPSPPPPPPPPPPPPPPPPPPPRRRRRRRRRRRRRRRRRRRRRRRRRRRRRRRRRRRRRRRRRRRRRRRRRRRRRSSSSPSYP
LLLLLLLLLLLLLLLLLLPPPPPPPPPPPPPPPPPPPPPPPPPPPPPPPPPPPPPPPPSPPPPPPPPPPPPPPPRRRRRRRRRRRRRRRRRRRRRRRRRRRRRRRRRSSPSYYYYYYYYYYYYYYYYY
LLSSLYYLSLLLYYLPPRPYPPYRRRRRRRRRPRLYRRRYYRRLYRRRRRYRRRRYRRRRRRRRRRRRRRRRRSSSYRRSSSSSSSRYLYPLRYYYYYLYRRSYYRYYYYPYYRYYLYYYYLYYYYYY
LRRRYRRRRRRRLRRLSYRSRYLLLRRRYRRLRRYRYRRRRRRRRRLRRRLRYRLSRLLRRRRSRRRYRRRRPRLRRLRRLRRRLRSLRRSRRLRRSYLLSSYLYRRYYLLYRRSYRYLLRSRLRRRY
PYPPPRSPRRPYRPPRRRRRRRRRRRRPRRRRRRRRRRRRRRRRRRRRRRRRRRRRRRRPRRRRRRRRRRRRRRRRRRRRRRRRRRRRRRRRRRPRRRRRRRRRRRPRRRRPSSSSSSSYPYYYPYYY
RPRRRPPRRRRPPRRYPPRPRRRRRRPRRRRRRSRRRRRPPRRRRRRRPRRRRRRRRRRRRRRRRRRRPPRRRRRRRRRRRRPRRRPRRRRRRRRRRRYPRRRRRRRRRRRRYRRPRRRRPRSPRPYY
RRRPRYRRRRRRRRRRRLYRRRRRRRRRRRRRRYYRYRRRRRRRRRRPRRYPRRRLRRRRRRRRRRRRRRRPRPRPRPRRRRRRRRRRRRRRLRRRRRRPRRRYRRRRRPRRRRRPPRPSRRRRRRPY
RRLRRYPYRRRRRRRRRRLRRRRRRRRRRRRRRRRRRRYRRRRRRRRRRRRRRRYRRRRRYRRRYRRPRRRRYRRRRRRRRRRRYRRYRRRLRRRRRRRLPRRRRRRRRRRSSSSSSRPRRRRRYPRY
PPLLPPRPPRLPPPPPRPPPPPPPPPPPPRPPPPPPPPPPPPSPPPPRPPPRPPRPPRPPRRPPPPRRRPRRRRRRPRRRRRRRPRRPPPRLRPRRRRRRRRRRRRRRRRRRRPPRPPRRRPRRRRPY
PPPPPPPPPPPPRRPPPPPPRPPPPPPPRPPPPPPPPPPPPPPPPPPPPPPRPRPRPPRPPPPPPPPPPPPPPPPPPPPRPRRRRRRRRRRRRRRRRRRRRRRRPRRRRRPRPPRRRPRPPRRRPYSP
RPRRPSPRRRRPRRRRRRRRRRRRRRRPRRRRRPRRRRRRRRRRRRRRRRRRRRRRRRRRRRRRRRRRRRRRRRRRRRRRRRPRRRRRRRRRRRRRRRRRRRRRRRRRRRRRRRRRRRRRRRRRRRYP
RRRPRPLSRRRRRPRRRRRPRRRRRRRRRRRRRRRRRRRRRRRRRRLRRRRRRRRRRRRPRRRRRRRRRRRRRRRRRRRRRRYRRRRRRRRRRRRRRRRRRLRRRRRRRRRRRRPRRRRRRRRRRRRR
RRRPRRPPPRPRYRRRRPRRPRRRRRPRRRRPRRRRRPRRRRRPRRRPPRRPSPPRPRRPRRRRRRRRRRRYPPRRPRRRRRRPRRRRRRRYRRYRRRRRRRRRRRRRRRRRRRRRRRRRRRRPYRRR
RRRRRRRRRRRPRRRYRRRRRRYRRRRRRRRRRRRRRRRRRRRRRRRRRRRRRRRRRRRRRRRRRRYRRRRRRRRRRRPRRRRRRRRRRLRRRRRRRRRRRRRRRRRRPRRRPRRRRRRRRRRPSLRP
LLLLLLLLLLLLLLLLLPLLLLLLLPPPPPYPPPPPPPPPPPPPPPLPPPPPPPPPPPPPPPPSPPPPPPPPPPPPPPPPPPPPPPPPPPPPPPPPRRRSSSSSSSSSSSPYYYYYYYPYYYYYYYYY
PRPPPPPPPRRRSPPRRRRRRRRRRRRRRPRRRRRRRRPRRRRPRRRRRRYRRRRRRRRRRRRRRRRRRRRRRRRRYRRRRRRRRRRRRRRRRRRRRRRRRPRRRRRRRRRRRRRRRSRSSPYRYYYY
RRPPSRSRRRRRRRRRRRRYYRLYPRRRLSPYRRRRRRRRRYLPRLRPPRRRRPPRRLRRRRRRRYRRRRRRRRRRRPYYRRRLRRRPRRPRRYRRRRRRLRRLRLRRRRRRRRRYRYSRRYRRRYYR
LLLLLLLLLLLLLLPPPPPPPPPPPPPPPPPPPPPPPPPSPPPPPPPPPPPPPPPPPPPPPPPPPPPPPPPPPPPPPPPPPPRRRRRRRRRRRRRRRRRRRRRRRRSPSYYYYYYYYYYYYYYYYYYY
RPRRRPPPYRRRRPRPRRRRRRPRPPRPPRRRRPRRRRRRRRRPRRRRRRRRRRRRRRRRRPRRRRRRPRRRRRRRRRRRPRRRPRPPRRRPRRRRPRPRRRRRRRRPRRRRRRRRPRPRRPPRPSSP
LPPPPPPPPPPPPPPPPPPPPPPPPPPPPPPPPPPPSPPPPPPPPPPPPPPPPPPPRPPPPPPPPPPPPPPPPPPPPPPPPPPPPPPPPPPPRPPPPPPRPRRRRRRRPRRRRSSSPSSSSSSYYYYY
LLRYRYRRRRYRRRRRLYYRSLSLRRYRYRLYRRRSRRRRRRRRRRRYRRRRRRRRRRRRRPRSRRRRRRRRRSRRRRRRRRRSRRYRRLRSSRRRLRRRRRRRRRRRRRRRLRRPRRRYRRRRRRYR
RRRRRRRRRRRPRRRRRRRRRRRRRRYRRRRRRRRRRRRRRRRRRRRRRRRRRRRRRRRRRRRRRRRRRPRRRRRRRRRRRRRPRRRRPRRRLSYLRRRRRRRRRPRRRRRRRRYRRRRYRRRRRRRR
LLLLRPPLLSLLPLLLPLLLLLLLLLLLLLLLLLLLLLLLLLPPLLLLPLLLLLLLLLLLSLLLLLLLLLLLPLLLLPLPLPLLPLPLLLLPLPLLLYPPLLLRLLPPLRLPLLLRPRRRLLRRLLPP
RRRRPRRRLSLYRPRRRRRRRRRRPRRRRRRRRRRRRRRRRRPRRRRRRRRRRRRRRRRRRRRRRRRRRRRRRRRRRRRRRPRRRRRRRRRRRRRRRRRRRRRRRRRRRRRRRRRRSRRRRRRRRRRR
PPPPPPPPPPPPPPPPPPPPPPPPPPPPPPPPPPPPPPPPPPPPPPPPPPPPPPPPPPPPPPPPPPPPPPPPPPPSPPPPPPPPPPPPPPPPPPPPPPPPPPPPPPRRRRRRRRRRRRRRPSSYYYYY
LLYLYRLLLPLPLPLPPLLPPPPPPPRPPPPLPPPLPPPPPRPPYPRYRPPLPSPPRPPYPPPPPPPLYPPPPPPLPPPPRPPRPPRPLRPPRRLRRRLRRRRRRPPYRYPPYYYYYYYYPYYYYLYR
YRRRRRRRRRRRRRRRRYRRRRYRRRYRYLLYRRRRRRRRRRRRRYRYYRRRYRRRRRRRRRRRSLYLYRYLLYYRRYRRYRRRRRRRYLYRRYRRRRRYRRRRLYRYRRYRRRYRRRRRRRRYRYRY
LLLLLLLLLLLLLLPPPPPPPPPPYPPPPPPPPPPPPPPRRRRRRRRRSSSSSSSSSSSSSSSSSSSSSSSSSSSSSSSSYYYYYYYYYYYYYYYYYYYYYYYYPYYYYYYYYYYYYYYYYYYYYYYY
RRRRYRRRRRRRRRRRRRRRRRYRRRRYLYRYSLLLLYYRPRRRRRRRRRRRRRYRRYYLYRRRYRRRRRRRRRRRRRRRRRRRRRRRRRRRRRRRRRRRRRRPYRRRYRRRRRRRRRRRYRRRRRRR
RLRPPRRRPPSPPPPRPPRPRPRPRRRRYSPYPPPRPRRPPPRPPRRRRPPRPRRRRRPYRRRPRRRRRRRRRRRRPRPRRPRRPRRRRPRRPYRRPRRRRRPRLRRPRLRRPPPSSPSPYYYRRRYY
LLPPPPPPPPRPPPRRPPPPPPPPPPPPPPPRPPPPPPPPPPPRRPPPPPPPPPPPPPPPPPPPPPPPPPPPPPRRPRPPPPRPPPRRRPPRRRRRPRRRRRRRRRPRRRRRRPPRPRPRPRRRPSSS
SLPRYYPRRYRRRPYRYYRPRRYYRRRRRYYYRRRYRYRRRYRYYYRRRRYRYRRYYYYRRYLYRYYYYYYYYYRYRRRYRRRYYYYRRRYRRYYYYPYRYSYRYRRRYYYRRYYYYYRYYYRYYYYR
LLPPPPPPPPYPPPPSPPPPPPPPPPPYPPPPYPPPPPPPPPPPRRRRRRRRRRRRRRRRRRRRRRRSSSSSSPYYPYYYYYYYPYYYYYYYYYYYYYYYYYYYYYYYPYYYYYYYYYYYYYYYYYYY
LPPPPPPPPPPPPPPPPPPPPPPPPPPPPRPPPPPPPPPPPPPPPPPPPPPPPPPPPPPPPPPPPPPPYPPPPPPPPPPPPPPPPRPPPPPPPPRRRRRRRRRRRRRRPYRRRRPRSSSSSSSSYPYR
LSLPPPPPPPPPPPPPPPPPPRPPPPPPPPPPPPPPPPPRRRRRRRRRRRRRRRRRRRRRRRRRRRRRRRRRRRRRRRRRRRSRRRRRRRRRRRRRRRRRRRRRRRRRRRRRRRPRRRRRRRRRRRLY
LLLLLLLLLLLLLLLLLPPPPPPPPPPPPSPPPPPPPPPPPPPPPPPYPPPPPRRRRRRRRRRRRRRRRSSSSSSSSSSSPSSSSSSSSSSSSSSSSSYYYYYYYYYYYYYYYYYYYYYYYPYYYYYY
RPRPPPPRRPRPPRPPRYPRPRRPRPRRRRRPRPYPRPPRRPRPSPPRRPRRRPRRRRRRRPPRPRRPRRRPPPRRRRPRRRPRRRRPPRRRRRRRRRPRRRRRRRRRRRPRRPPRRPRPYRRRYYRP
LLSLRPPPPRPRRPPRRPPLRRPRRRRRRRRRPSRRRRPPRRRRRRRRRRRRRRYRRRRPRYRRPRRRRRRRRRRRRRRRPRRRRPPSPRRRRRRRRRRRRRRRRRRRRRRRRRRRRRRRSRPRRYYR
SLLLLSLLLSYPRPPRRPPRRRRRRRRRRRRRRRRRRRPRRYRRRRRRRRRRRRRRYRRRRRRYRPYRRRRSYRRRYYRRRRRRSSSSSSLSPSSSSSSSSSSSSLSSLRYYYYYYRRRRYYRYRLYY
LLLYPRPPPPPPPYPRPRYPRYPYPPPPPRYPSPPPPPPPRPYYRPRPPRRYRRYPPRPRYYRRYSPYYYYRYYYLPYYYYPYYYYRYPYYYYRYYYYYYYYYPYRYYYYYYYYYYYPYYYPYYYRYR
LPRPYRPYYPRPPPPRPYPPPPLYRRPRPPPYPRYPPPPPRRPPYPPYYYRPYPPPRRRRRRRRPRRRYRRRYYPRRPPRRRRRPPRRPPYRRRLRSPPYRPYRPPRPYPPYYYPYYPYPYYYYPPYY
SPPRPPPPPPRPPPPPRPPPPPPPPPPPPPPPPPRRRRRRRRRRPRRRRRRRRRRRRRRRRRRRRRRRRRRRRRRRRPRRRRRRRRRRRRRRRRRRRRRRRRRRRRRRRRRRRRRRRRPRRRRRRPYY
RRRRRRRRRRYYRRRRRRRRRRRRRRYRRRRRRRRRRRRRRRRPRRYRRRRRRRRRRRRRRRRRYRRLRYRRRPRRRRRRRYRRRRRRRRRRRRRRRYRRRRRRRRRYRPRRYRRPYLSSRPRYYRRY
PPRPPPRPRPSPPRPRRRPRRRRRRRRRRRRRRRRRRRRRRRRPRRRRRRRRRRRRRRRRRRRRRRRRRRRRRRRRRRRRRRRRRRRRRRRRRRRRRRRRRPRRRRSRRRRRRRRRRRRPRRPRSSYY
RRPRRRRYRRRRRRYRRRRRLRRRRRRRRRYRRRRRLLRRRRRRRRRRYRRRRRRSLRRRRRRRRYRRRRRRRPRRYRRRRRRRRRRRRRRRRRYRRRLYLRRPRRRRRRRRSPYLYYYLPYRRRRRR
RYYRRRRRRRRYYRLYRRRRRRYRRRRRRRRRRRRRRRRYRRRRRRRRRYRRRRYRRRRRRRRRRRYRRRRRRRPRRRRRYRRRRRRRRRRRRRRRLLYRRRRYRRRYRRYRRRRYLYRYLYRYLSYL
RPRYPPYPYYPPRPPPRPPYPYPSPYYYPPYYPPYPPPPPPRPRRPYYPRPRRPYRPRRYYYPRRRRRYYSPYYPYRYYRYYRYYPRYPYYYYPYRRYRRYRYYYPYYRPYYYYYYYYYYYPYPYRPY
RRRRRRRRRPRPRRRLPPRPRPPRRRRRRRRRRRRRRRRRRPRRRRRRRYRRRRRRRLRRPLRPRRRRRRRRRRRRYRRRLPPRRRRRRRRRRPRRRRRLRPRRPRRRRRRSRRRPLRRRRRRPLSPR
LLLLRRRLPPPRRPRPYPPPRPPPPPPYRPRLPYPPRPRRRRRRRRRRRRYRRRRRRYRRPSYRPRYYYYYRYRRRRRRPRRRRRRRRRRYRPRLYRRRPLSPYRRRYPYRPYYYRYPYLYRYPYRRP
PRPPPPPPPPPPPPPPPPPPPPPPSPPPPPPPPPPPPPPPPPPPPPPPRPPPPPPPPPPPPPPPPPPPPPRPPPPPPPPPPPPPRRRRRRRRRRRRRRRRRRRRRPRRRRRRRRPPRRRRRRPYYYYY
LLLPPPPPPPPPPPPPPPPPPPPPPPPPSPPPPPPPPPPPPPPPPPPPPPPPPPPPPPPPPPPPPPPPPPPPPPPRRRRRRRRRRRRRRRRRRRRRRRRRRRRRRRRRRRSSSSSSSPSSSSSSSSSS
LPPPPPRPYPPPSPPPPPPPPPRYPPPPPPYPPPPPPPPPRRRRRRRRRPRRRRRRPRRRRRRRRRRRRRRRRRRRRRRRRRYRRRSRSPSSSSSSSSSSPSSSSSSRSSSSSSSYRYYYPYYYPYYY
LPRPSPPPPRPPPPPPPPRPRRRRRRRPRRRRRRRRRRSRRRRRRRRRRRPRRRRRSRRRSRRRRRRRRRRRRRRSSRPRSSSSRSSSSSSSSSSSSRSSSRSSSSSSRSSSPSSSSSSSYYYYYYYY
YRYLLPLSLYLSRYSSSYSYSYLYYYSYSRSYSSSSSSSSSSSSSSSSSSSSSSSSSSSSSSSSYSYSSLYYYYYYYYYYYYYYYYYYYYYYYYYYYYSYYSYYYSYYSSYYSLYYSPYYLYSYSYSY
RPPLPPPRPPSPPPPPPPPPPPPPPPLPPPPPPPPPPPPPPPPPPPPPPRLPRRRPPPSRRRRLRRRRPRRSRRRRRYRRRRPRRPRRRRRRRRRRRRPRRPRRRRRSSSRSPSSSSSSSSRSSYYYR
RRRRRRRRRRRRRRRRRRRRRYPRRRRRRYRRRRRPPRPSRRRRPRRYRRRRRRRRRRRRSRPRPPRRRRRRRRRRRRRRRRRRRRRRRRRRRRRRRRRRRRRRRRRPRRRRPRRRRPRRRRRRPRRR
RRRPRRRRPRPSRYPRRRRYRRRRRRRRRYPYRRYPRYRRRRRRYRRYYRYYRRRRRYRRRRRRRYRRYRSYRPRRRRPRRRYRYRRRRYPRYRRRRYRYRRRRRRRRRRRRRRRYRYRYYRRSRRRR
LLLLSLLLPPRPPPPPRPRRRRRRRRRRRRRRRRRRRRRRRPRRRRRRRYRRRRRRRRRRRRRRRRRRRRRRRRRRRRRRRRRRRRRRRPRRRRRRRRRRRRRRRRRRRRRRRRRLSSSSYYRYYYYY
RYRRRRRRRRRRRYRRRRRRRRRSRRRRRRRRRRYRRYYLRRRRYRRRRRRRYRLRRRRRRRRRRRRRRRRYRRRRRYRRYRYLRRRYRLYRRRRRLYRYSSSSRSYRYLRYRRRYYLYRRYRRRRRR
LSLLSLLLLSLYLLSLLPPPPRYPPPSRRRRRPRRSYRRRRRSRYRRRRRRRRRRRRRRRRRRLSYSSYSSSSSSYSRSSLSYSSSLSYSRSSRSSYRSSLSSSYPYYYYYYRSYRSLYYYSYYYRYR
LPPPPPPPPPPPPRPPPPPPPPPPPPPPPPPPPPPPPPPPPPPPPPPPPPPPPPPPPPPPPPPPPPPPPSPPPPPPPPPRRRRRRRRRRRRRRRPRRRRRRRRRRRRRRRRRPYYYYYYYYYYYYYYY
LLLLLLLLLLLLLLLLLLSPPPPPPPPPPPPPPPPPRPPPPPPPYPPPPPPRPRRRRRRRRRRRRRRRRRRRRRRRRRRRRRRRRRRRRRRRRRRRRRRRRRRSLSSSSYYYYYPYYYYYYYYYYYYY
RLLLPRPRPSYPPPRRPRPRRRRRRLRRRRRRRYPRRRPRRRSRRSRRRRRRRRRSPRRRRRRRRRPRRRRRRRRRSRRPRRRRRRRPRRRRRRRRRRRRRRRRRRRRRRRRRRPSPRSSSRSRSRYL
PPPPPPPPPPPPPPPPPPPPPPPPPPPPPPPPPPPPPPPPPPPPPPPPPPPPPPPPPPPSPPPPPPPRRRRRRRRRRRRRRRRRRRRRRRRRRRRRRRRRRRRRRRRRRRRRRRRRRRRPSYYYYYYY
RRPRPPPRRPRPRPPRPPRPRPRPRRRRRRRRRRRRRRRRRRRRRRPRRRRPRRRRRRPRRPRRRRRRRRRPPRPSRPRRRRRRPPRRRRRYRRRRRRRRRRRRRRRRPRRRRRRRRRRPRRRRRRPR
LLLLLLLLPLLLLLPYPPLLPPPRRPLPPPPPSPPPPPPPPLPPPPPPPPPPPPPLPPPPPPPPPPPPRRRRRRRRLRRRRRRRRRRRRRRRPRRRRSRRPRRRRRRRRRRRRRRRSSSRRSSSSSYL
YPPPPPPPYYPYYRPPPPSPPPPPPRPPPYPRPRRRRRRRPYRRPYRRYRYRPSYYRYYYYYYYYYPYYRYYYYPYYYYYYYYYYYYYYYYYYYYYYYYYYYYYYYYYYYYRPYYYYLRYRYYYYPYY
LPLPPLLLLLLLLLRPPLPLPPPPPPPPPRPSPPPLPPPPPRPPPPPPSPPPPPLPLRPPPPPRRRRRRRRRRRPRRRLRRRRRRRRRRRRRRRRRRPRRPRRRRRRRRRRRRRRSSSSPSSPSSYYY
YPRRPYLSRRRRRRYPPRRRRRRYRRRRSRRLPRRRRRYSRRRRRRYRPYLRRRRRRRRRPLRRLYRRRRRLRRRRRRRRRRRRRRYRRYPRRRRRRRRRRYRRRYYRRRRYRRRRYYLRRRRRPRRY
LLRLLLLLLLLPPPPPPPPPPPPYPRPRPPPPPPPPPPPPPPPPPPPPPRRRRRRRRRRRRRRRRRRRRRRRRRPRRRRRRRRRRRRRRRRRRRRRRRRRRRRRRRRRRPLRRPRRSSSSYYPYYYYY
RRRPRRPRRRRRRRRRRRRRRRYRRPRRRRRRRRRRPRRRRRRRRPRRRRRRRRRPRRPRRRRRRRYRRRRRRRRRRPRRRRRRRRRPRRRRRRRRRRRRYRRRRPPRPRRPRPRRRRRRPRRRSPRP
PPPPPPPPPPPPPYPPPRLPPPPRPPPPPPPRPPPPPPPPRPRPPPPPPYPRRPPPPPPPRPPPPPRPPPRPPPPPPPPPPRPPPPPPPPPPPPPPRPRRPRRPRRRPRPRPRPPRRPRRRPPRSPYP
SYLLYSYPYPPSPSSSYPPPLYYSSPSYPSLLSSSSYSSPSSPSPSSSYSYSYYYYYSYLYYSYSYYYSYYYYYYYSSYSRSYYYYYYYYYYYYYYPYSYYYYYYSYSYYYYYYLYYYYYYYYYSYYY
LRRRLLLLPRRPPPRPPPRPRRSRRRRRRRLRRLRRRRRRRRRRSRRRRRRRRRRRLRRRRRRRRRRRRYPRRRRSRSRRRRRSRPRRRRRRRRRRRRRRRRRPRRSRSSRSSSSSSSSSRSRPYRYY
RLLSRPRRRPRPPRRRRRRRPRRRRRRSRRRRRRRRRPRRRRRRRRRRRRRRRRSRRRPRRRRRRRRRRRRRRRRRRRLRRRRRRRRRRRRRRPRRRRRRRRRRRRRRRPRRRRPRRRRSPSSSSSSS
RPPPRRPRRRRRPRPRRRYRRPRRRRRRRRRRPPRRRRYRRRRRRRRRYPRRPRRRRRRRRRRRPPRRRRRRRRRRRRRRPRRRRRRRRRPRRRRRRRRRPRRRRRRPRRRRRRRRRRPRPRPSSPPR
LLRPPPPPPPPPPPPPPPPPPPPPPPPPPPPPPPPPPPPPPPPPPPPPPPPPRPPPPRPPYPPPPPPPPYPPPPPPPPPRRPRRRRRRRRRRRRRRRRRRRRRRRRRRRRPRRPSSYYYPYYYPYYYY
LYRLRRLLLLYLYLYRYLPYLPLYRYYLLYLRLLRLLLLPLRLLRLLPPPPYLRPPRRLLLRPPRLLRRRLLRPRLYRYRSYRRRRRLRRRPRRYRRYPLLYYYYPYYLYLLLLYLSLPYYPRLRRRY
LLLLLLLLLLLPPPPPPPPPPPPPPPPPPPPPPPPPPPPPYPPPPPPPPPPPPPPPPPPPPPPYPPPPPPPPPPPPPPPPPPPPPPPPPPPPPPPPPPPPPPRRRSSSSSSSSSSSYPYYYYYYYYPY
RRRRRRPRRRRRRRRRPRRRRPSPRPRRRRRRRRRRRRRRRRLRRRRRRRRRPRRRRRRRRRRRRRRRRRRRRRRRRLRRRRRRRRRRRRRRPRRRRRRRRRRRRRRRRRRRRRRRPLRRRRRRRRRR
LLLLLYLLLLLLLLLLLLPPPSPPPPPRPPPPPPPRRPRRRRRRRRRRRRRRRRRRRRYRRRRRRRRRRRRRRRYSSSSSSSSSSSSSPSSSSSSSSSSYSSSSSSSSRYYSLYYYYYYYYYYYYSYY
RRRRRRRRRRRRRRRRRRRRRYRRSRRRRRRRRRSRRRRRRRRRRPRLRRRRRRSRRRRRRRRRRYRRRRRRRRRRRSRRPRRRLRRRRRRRRRRRRRRRRRRRRRRRPRRLRRRYYRPRSSRPPRRR
YYYYPRYPYPYYYYYYYYYYPRRRRYYYYYYYYYRYPYYYPYRYSYYYYYYYYYYYRRRYYPYYRRPYYPYPYYYYYYYYYYYYYYPYPSYPYPPYPRYRYRYYYRYYYYYYYPYYYYYYYPYYPYYY
LRRRLPPPRPPPPPRRPPYRLRRPPPRRRPRRRPPPRPPPPPPPPPPRPPPPPPSPLPPPRLPPPPPLPPRRRRPRPRRPRRRRPRRPRRPRRRPRRRRRRRRPRRPRRRRPRRRRPRRRRRPPRRRR
PRRYRRRYRRRYRRRRRRRRRRRRRYRRRYYRRRPRYPPSRPRRRRRRRRRRRRRRRRPRRRRRRRRRRRRRRRRRRYRRRRRYRRRRRRRRRRRRRRRRRRRRYRRRRRRRRRRRPRRRRRRRYYRR
RRPRRRRLPRRRPLPSLYRRRRRRLRRRRPRRRRRRRRYRRRRRRRRRRRRPYRRRRRYRRRRPRRRSRRRRRRRRRRRYRRRRLRRRRRYRYRRRRLRRRRRRRLRRRRRRRRRLRRRRRRRRRRPR
LPPPPPPPPPPPSPPPPPPPPPPPPPPPPPPPPPPPPPPPPPPPPPPPPPPPPPPRRRRRRRRRRRRRRRRRRRRRRRRRRRRRRRRRRRRRRRRRRRRRRRRRRRRRRRRRRRRRRSRPRRPRSSYY
LLLYYRPRYPYLPPYPLYYPPPPYPRYRYPPRPPRYPPRPPYYRYYPRRPRRLPRYYPYRRPRRPRYRPRPSYYYYPYRYYYYYPPRRYYPPYYYYYPYYYYYYYYYYYPYRPYPYRPRYYYYYRRYR
YYYLSPRPSRPYYYYRYRLRSRYRYRRRRYYPYYYYYYYYYLSYYYSSYYSYSYYSSYYYYYPRYYRSYYLYRYYYSRYRRYYRYLYRYSYYYYSPYRRRYYYYSYYPYYSRYRYYYRYYYRYRSRYR
LLLSLLRPRPPYRPRPPPRRYRLRYRRRRRRRRRRYRPRRRRRRYYRRRRRRRRRRRRRRRRRRRRRRRRRYRRRRRRPRRSRRRRRRRRRRRRRSRRRRRRRRRRRPRRSPPRYRRRRYRYYYRRYY
