PSPRPRSRRPRRRRRRRRRRRRRPRRRSSSPS
RRRRPRRRRPRRRRRRRRRRRRRPPRRRPRSS
RRPRRRYRRRRYRRRRRRRRRPRRRRRPSLRP
LLYRYRYRRYRRRRRRYYRPLSYLRRRYLYYR
RRPPPRRPLRPYRLPRRYRPRRRPRRPRSSPR
PPPPYPPPPPPRPPSPPPPYYYYYYYYYYYYY
LSLYYLYRYRSYYYYLYYRYRYRLYRRYLYYR
LSLLYLRYRRRPRYRRRRRRRRRYRRYRRPRY
LRYRYLYRRLRLRLRYYRLYLSYLSYRRYLYR
RPPSPPPPPPPPRRLSPYYYYYYYYYYYYYYY
LPPPPPPPPPPPPPSPPPRRRRRRRRRRPSSY
RRRYRRYRRYRRYLYRRLRRPRRRSSLYRRRP
LLRPPRRRPSPPRRRPRRYRRPRPRRRRPRPL
LRPPPRPPRPYPRRRRRPPLRRPRRRPRPSYP
SLRPRPRPPPPPPPPPPRPLRRLRRRRRPYYY
RLLPPPLYPSRRRRRPRPRRRRRRRPPRRPSP
LRPYSPRSSRRRSRRRSSRPSSPYSPYYSYYP
PPPPRPPPPPRPPRRRRRRRRPRRRRPRSSSS
LPPLPPPPPPPSPPPPPPRRRRRSPYYYYYYY
LLRLRLLRPPPRRRPRRRRPRRLRRPRRPLPS
RYRRRRRRRRYYRYLYLLYRLYLSRRYRLYYR
SRRPPRLSRRPRRRSRYPRYRRRRRYSRRRRY
RPRRSLPPSRPRRRRRRPRPRRRRRRRRSRRP
SLRYRRRPRSLRLRLRRLPRRRRLLRPRSPLS
PYSLPRYYLYSYRSYYRRYRRRRRYRLYRYRR
LLPYPPPPPPPPPPPPPRRRRRRRSSSSSSSP
LLLLLPPPPPPPPSPPPPPRRRRRRRRSPSSY
LLPSPPPPPPPPYPRRSRRRRRPSSRYYYYYP
RPRRSSSLRRLSRPRRRRRRRRRRRPRRRRRL
SRPRRRRRRRRPRRRRPPRRRRRRPRRRRPLS
PRRRRRRRPRLRRRLRRLSRRPRRRRRPLLSS
LPPPPPPRPRRRRRRRRRRRRRPRSSSSSSSS
PPPRPPPYPPPPPPRPPYPSYRPRPPRYPYPY
YRRRRRRRPRRRRRRRPRLSRRPRRRRRPRRR
RPPPPPPPPPPPPSPPRRRRPRYYYYYYYYYP
RPYRLYSLRRPRRRRRYRYLRRRYRRRRRYRR
YLRYLLSSYYLYYYRRRYYYRRRRRRYRRYYL
RRRRRRRSRRRYSRRPRRPRRRRRSSRPRRPR
PPPPPPPPSPPPPPPPPPRRRSPSYYYYYYYY
LLLPLLLLLLPPPLYPPPRPPPPPPPRSSSYP
RRRRPRYRYRYLSLRPRRRYLLRYRRRRRYRR
PPPPPYPPPPSPPRRRRRYSSSSPYYYPYSYY
LLLPPPSPPRRRRRRRPRRSRRRRRRRSRSRS
RYYLYRRRSLLYPRRRRPRRRRRRRRRRRRRR
LPPPSPPPPRPRRRRRRRRRRRRSRRPRSRSP
YRYRRRYRLYYRYYRYSLLLYLRYRYYYRYLY
LLLPPPPPPPSPPPPPPPPRRRRRRRSPSYSS
PPRRPSSPPPPPRRPPRSRSRPSRRSSPSRSY
RPRRRRRRRRRRRRRRRPRRSLYLRYYLRRYR
RRPPPRYYPPRRPRRRYRRRPYRRRRYPPSPY
