RRRPRRRRPRRSSPPPRPSRRSRSRSRRRRRR
RRRRRRRRRPRRRRRRRRRPPRPSRRRRRSPR
RRRRRRPRRRPRSLRPRRRYRRRRRRRRRRPY
LYYRLYLSYRPRRRRRLYYRRYYRYYRRRRRL
RLRRPRPPLSRPRPRSRPYRRPPPRRRRYRPR
PYYYPPPYPYPPPPPSYRPPYYYPYPYPPYYY
RRRYRYYLSYYRYLRYYYYYLYYRLYLSLYYR
PYRRRRRRRYRYLRRRSLLYYLRYRPRRRRRR
LYRYRRRYRLRLRRYYYRRLLYSYLSLLYRYL
RPYPPPRYPPYPSLYPYPYYYRYPYSYYYYPY
RRPPYRPLPPPPRPPRSPPPSRRPRRPPPSRP
YRRRRRPRLSLYLYYRRYRRRRPYSRRRRRRR
RRRPSPPPRRPRPPRRRRPRYRPRPRLRLLRR
PLRRRRPRSPRPRRPRPPPPRYPLPPRRPYRR
RRRPLRPRPPRPPPYRPPLYSPPRYRPRLPPR
RRRPRRPPPRPSPPLSRRRRPRPRRRLPYLRR
SYPRSSYSSRSRRRSRRPSYPRSPRYPYYSLP
PRPRRRRSPRRPPRPPRPPPRRPRRPRSPRSS
YPYPYLRPYPPPRPPPPPRSSPPPPPYRLYRY
LPPRRPLSPPRLRRRLRRPRPRRRRPRLLRRL
LYYLRYRRYLSLRYLYRRRYRYLYRRRRRRRY
RRRRYRRRRSRYSYPYRLPRRRRRPRSSRRPR
SSRPPRRPRRPRRRRRRRRRSPRRRRLRPRRP
LRSRRYRLRLPRSRSRLRRPPRSLRPRRLRLL
SSLLLYYYRRRYPYYYYRRRRYRRYRRSPRYR
SPPYLSPPPPRPPPPLPPRSPSRRSPPRSRSR
PYLRPRPRLSPPPPPLRSPSRLLRPPRPPPSR
PYPLRSRPSPPPPPYPSRRRRYSRYYPRPPYL
RRSRPRRRSRPRLLSLRRRRPRRRRRRRSRRR
RPPRRPPSRLRPRRRRRRRRPRRRRRRRRRRS
RPRPLSLSLRRRSRPRRRPRRRRLRRRRRLRR
PRRRPRSPSSRSRRPRLRPSRSPSPRRRPSRR
SPPPPPPPPPPYPPRPRPPPYYPPRYRRYPPY
SLRPRRRPPRRRRRRRRPRRRYRRRRRRRRRR
PYSPPRRRPYPYPYPPPPPPPYYPYRRYYPPR
RYRRPRRRSLYLRPRRLYYRRRYRRYRRRRRR
YRYLRYRRRRRSRYRYRYYRYLRYYLSLYLYY
SSPSPRRRRRYRRRRPRRRRRRRRRRPRRRRS
PYRPPPYPSPYPYYPPPSYYPPRPYPPSPPPR
PYLRPLRPLPYLPLSPPLPPPPLPPPLPLSLS
PRRRYLLSRYRPRRRRRYRRRRYRYRRRRYLL
PYSPPYYYRPPYRPPSRPYPPYYPSRSRSPSP
PRSRSRSRRSRRRRRRRPRRLRLRSPPRLPRP
YRLYLSLYPRRRRRRRRRRRRRRRRRRRRPRY
RRSLRRPPSPPRPRRRSRRPSRRRRRRRPPPP
SLLYYRYLLYRYRRYRRYRYYLRRLYYYYYRY
SLRPPPPPPPSPSPRPPPPRYSLPPLSRRRPR
PRRSPRSRSPSPPPRPSRPYSRSPRSRPPPRS
RRRRRRRRRRYRRRPRLYYRLYSLRRRRPRRR
RPRYYYRYRPRPRRRRPRPSPYRPRRPYRPRP
