SSSSSSSSSSSSSSSSSSSPPRPRPRRRPRRR
SSSPPRRRPRRRPRRRPRRRPRRRPRRRPRRR
SPPPPPPPPPPPPRRRPRRRPRRRPRRRPRRR
SSSSSSSSSSSPPPPRPRRRPRRRPRRRPRRR
SSSPPPPPPPPPPPPPPPPPPRPRPRRRPRRR
SSSSSSSSSSSSSSSSSSSSSPPPPPPPPRPR
SSSPPRRRPRRRPRRRPRRRPRRRPRRRPRRR
SSSSSSSPPRRRPRRRPRRRPRRRPRRRPRRR
SSSSSSSSSSSSSSPPPPPPPPPPPRRRPRRR
SSSSSSSSSPPPPRRRPRRRPRRRPRRRPRRR
SSPPPPPPPPPPPPPPPPPPPPPPPPPPPRRR
SSSPPRRRPRRRPRRRPRRRPRRRPRRRPRRR
SSSSSSSSSSSSSSSSSSSSPRPRPRRRPRRR
SSSSSSSSSSSSSPPRPRRRPRRRPRRRPRRR
SSSPPRPRPRRRPRRRPRRRPRRRPRRRPRRR
SSPPPPPPPPPPPRRRPRRRPRRRPRRRPRRR
SSSSSSSSSSSSSSSSSRPRPRRRPRRRPRRR
SSSSSSPPPPPPPPPPPPPPPPPPPPPPPRRR
SPPPPPPPPPPPPRRRPRRRPRRRPRRRPRRR
SPPRPRRRPRRRPRRRPRRRPRRRPRRRPRRR
SSSSSSSSSSSSSSSSSSSPPPPPPRRRPRRR
SSSSSSSSPPPPPPPPPPPPPPPPPRPRPRRR
SSSSSSSSSSSSSSSSSSSSSSPPPPPPPPPR
SSSSPPPPPRRRPRRRPRRRPRRRPRRRPRRR
SSSSSSSSSSPPPRRRPRRRPRRRPRRRPRRR
SSSSSSSSSSSSSSSSSSSSSPPPPRPRPRRR
SSSSSSSSSSPPPRPRPRRRPRRRPRRRPRRR
SSSSSSSSSSSSSSSPPPPPPPPPPRPRPRRR
SSSSSSSSSSPPPPPRPRRRPRRRPRRRPRRR
SSPPPRPRPRRRPRRRPRRRPRRRPRRRPRRR
SSSSSSSSSSSSSSSSSPPPPPPPPRRRPRRR
SSSSSSSSSPPPPPPPPPPPPPPPPPPRPRRR
SSSSSSSSSSSSSSSSSSSSSSPPPPPPPRRR
SSSPPPPPPRPRPRRRPRRRPRRRPRRRPRRR
SSSSSSSSSSSSSSSSSPPPPPPRPRRRPRRR
SSSPPPPPPPPPPPPPPPPPPPPPPPPPPRRR
SSSSSSSSPPPPPPPPPPPPPPPPPRPRPRRR
SPPPPPPPPPPPPPPPPPPPPRPRPRRRPRRR
SSSSSSSPPPPRPRRRPRRRPRRRPRRRPRRR
SSSSPPPPPPPPPPPPPPPPPPPPPPPPPRRR
SSSSSSSSSSPPPPPRPRRRPRRRPRRRPRRR
SSSPPPPRPRRRPRRRPRRRPRRRPRRRPRRR
SSSSSSSPPPPPPPPPPRPRPRRRPRRRPRRR
SSSSSSSSSSSSPPPPPPPPPPPPPPPPPRPR
SSSSSSSSSSSSSSSSSSSSSSSPPPPPPPPR
SSSSSSSSSPPPPPPPPRRRPRRRPRRRPRRR
SSSSSSSPPPPPPPPPPPPPPPPPPPPPPPPR
SSSSPPPPPPPPPPPPPPPPPPPPPRRRPRRR
SSSSPPPRPRRRPRRRPRRRPRRRPRRRPRRR
SSSSSSPPPPPPPPPPPPPPPPPPPPPPPRPR
