SSSSSSPRPRRRPRRRPRRRPRRRPRRRPRRR
SPPRPRRRPRRRPRRRPRRRPRRRPRRRPRRR
SSSSSRPRPRRRPRRRPRRRPRRRPRRRPRRR
SPPPPPPPPRRRPRRRPRRRPRRRPRRRPRRR
SSPPPPPPPPPPPPPRPRRRPRRRPRRRPRRR
SPPRPRRRPRRRPRRRPRRRPRRRPRRRPRRR
SSSSSSSSSSPPPPPPPRPRPRRRPRRRPRRR
SSSSSSSSSSSSSPPPPPPPPPPPPPPPPRPR
SSSSSSSSSSSSSSPPPPPPPPPPPPPPPRPR
SSSSSSSSSSSSSSSSSSSPPPPPPRRRPRRR
SSSSSPPPPRPRPRRRPRRRPRRRPRRRPRRR
SSSSSPPPPPPPPPPRPRRRPRRRPRRRPRRR
SSSSSSSSSSSSSSSSSSSSSSSSPPPPPRPR
SSSSSPPPPPPRPRRRPRRRPRRRPRRRPRRR
SSSSSRPRPRRRPRRRPRRRPRRRPRRRPRRR
SSSSSSSSSSSSSSPPPPPPPPPPPRPRPRRR
SSSSSSSSSSSSSSSSSSSSSPPPPPPPPRRR
SSSSSSSSSSSSSSSSPRRRPRRRPRRRPRRR
SSSPPPPPPPPPPPPPPPPPPPPPPRPRPRRR
SSSSSSSSSPPPPPPPPPPPPPPPPPPPPPPR
SSPPPRRRPRRRPRRRPRRRPRRRPRRRPRRR
SSSSSPPPPRRRPRRRPRRRPRRRPRRRPRRR
SSSSSSSSSSSSSSSSSSSSSSSPPRPRPRRR
SSSSSSSSSSSSSSSSSSPPPRPRPRRRPRRR
SSSPPPPPPPPPPPPPPPPPPPPPPPPPPPPR
SSSSSSSPPPPPPRPRPRRRPRRRPRRRPRRR
SSSSSSSSSSSSSSPPPPPRPRRRPRRRPRRR
SSSSSSSSSSSSSSSSSSSPPPPPPPPPPRRR
SSSSSPPRPRRRPRRRPRRRPRRRPRRRPRRR
SSSSSSSSPPPPPPPPPRPRPRRRPRRRPRRR
SSSPPPPPPPPPPPPRPRRRPRRRPRRRPRRR
SSSSSSSSSSSSSSSSSSSSSPPPPRRRPRRR
SSSSPPPPPRPRPRRRPRRRPRRRPRRRPRRR
SSSSSSSSSSPPPPPPPPPPPPPPPPPRPRRR
SPPPPPPRPRRRPRRRPRRRPRRRPRRRPRRR
SSSSSPPPPPPPPPPPPPPPPRPRPRRRPRRR
SSSPPPPPPRPRPRRRPRRRPRRRPRRRPRRR
SSSSSSSSSSSPPRPRPRRRPRRRPRRRPRRR
SSSSSSPPPPPPPRRRPRRRPRRRPRRRPRRR
SSPPPPPRPRRRPRRRPRRRPRRRPRRRPRRR
SSSSSSSSPPPPPPPPPRPRPRRRPRRRPRRR
SSSSSSSSSSSSSSSSSPPPPPPRPRRRPRRR
SSSSSSSSSSSSSPPPPPPPPPPPPPPPPRPR
SSSSSSSSSSPPPRRRPRRRPRRRPRRRPRRR
SSSSSSSSSPPPPRPRPRRRPRRRPRRRPRRR
SSSSSSSSSSSSSSSSSSPPPPPPPRPRPRRR
SSSSSSSSSSSSSSSSSSSSPRPRPRRRPRRR
SSSSSSSSSPPPPRRRPRRRPRRRPRRRPRRR
SSPPPPPPPPPPPRRRPRRRPRRRPRRRPRRR
SSSSSSSSSSSSSSSSPRRRPRRRPRRRPRRR
