SSSSSSSSSSSSSSSSSSSSSSSSSSSSSSSSSSSPPPPPPPPPPPPPPPPPPPPPPPPPPPPPPPPPPPPPPPPPPPPPPPPPPPPPPPPPPPPPPPPPPPPPPPPPPPPPPPPPPPPPPRRRPRRR
SSSSSSSSSSSSSSSSSSSSSSSSSSSSSSSSSSSSSSSSSSSSSSSSSSSSSSSSSSSSSSSSSSSSSSSSSSSSSPPPPPPPPPPPPPPPPPPPPPPPPPPPPPPPPPPPPPPPPPPPPPPPPRRR
SSSSSSSSSSSSSSSPPPPPPPPPPPPPPPPPPRPRPRRRPRRRPRRRPRRRPRRRPRRRPRRRPRRRPRRRPRRRPRRRPRRRPRRRPRRRPRRRPRRRPRRRPRRRPRRRPRRRPRRRPRRRPRRR
SSSSSSSSSSSSSSSSSSSPPPPPPPPPPPPPPPPPPPPPPPPPPPPRPRRRPRRRPRRRPRRRPRRRPRRRPRRRPRRRPRRRPRRRPRRRPRRRPRRRPRRRPRRRPRRRPRRRPRRRPRRRPRRR
SSSSSSSSSSSSSSSSSSSSSSSSSSSSSSSSSSSSSSSSSSSSSSSSSSSSSSSSSSSSSSSSSSSSSSSSSSSSSSSSSSSSSSSSSSSSSSSSSSSSSSSSSSSSSSSSSSPPPRRRPRRRPRRR
SSSSSSSSSSSSSSSSSSSSSSSSSSPPPPPPPPPPPPPPPPPPPPPPPPPPPPPPPRRRPRRRPRRRPRRRPRRRPRRRPRRRPRRRPRRRPRRRPRRRPRRRPRRRPRRRPRRRPRRRPRRRPRRR
SSSSSSSSSSSSSSPPPPPPPPPPPPPPPPPPPPPPPPPPPRRRPRRRPRRRPRRRPRRRPRRRPRRRPRRRPRRRPRRRPRRRPRRRPRRRPRRRPRRRPRRRPRRRPRRRPRRRPRRRPRRRPRRR
SSSSSSSSSSSSSSSSSSSSSSSSSSSSSSSSSSSSSSSSSSSSSSSSSSSSSSSSSSSSSSSSSSSSSSSSSSSSSSSSSSSSSSSSSSSSSSSSSSSSSSSSSSSSSSSSSPPRPRRRPRRRPRRR
SSSSSSSSSSSSSSSSSSSSSSSSSSSSSSSSSSSSSSSSSSSSSSSSSSSPPPPPPPPPPPPPPPPPPPPPPPPPPPPPPPPPPPPPPPPPPPPPPPPPPPPPPPPPPPPPPPPPPPPRPRRRPRRR
SSSSSSSSSSPPPPPPPPPPPPPPPPPPPPPPPPPPPPPPPPPPPPPPPPPPPPPPPPPPPPPPPPPPPPPPPPPPPRPRPRRRPRRRPRRRPRRRPRRRPRRRPRRRPRRRPRRRPRRRPRRRPRRR
SSSSPRPRPRRRPRRRPRRRPRRRPRRRPRRRPRRRPRRRPRRRPRRRPRRRPRRRPRRRPRRRPRRRPRRRPRRRPRRRPRRRPRRRPRRRPRRRPRRRPRRRPRRRPRRRPRRRPRRRPRRRPRRR
SSSSPPPPPPPPPPPPPPPRPRRRPRRRPRRRPRRRPRRRPRRRPRRRPRRRPRRRPRRRPRRRPRRRPRRRPRRRPRRRPRRRPRRRPRRRPRRRPRRRPRRRPRRRPRRRPRRRPRRRPRRRPRRR
SSSSSPPPPPPPPPPPPPPPPPPRPRRRPRRRPRRRPRRRPRRRPRRRPRRRPRRRPRRRPRRRPRRRPRRRPRRRPRRRPRRRPRRRPRRRPRRRPRRRPRRRPRRRPRRRPRRRPRRRPRRRPRRR
SSSSSSSSSSSSSPPPPPPPPPPPPPPPPPPPPPPPPPPPPPPPPPPPPPPPPPPPPPPPPPPPPPPPPPPPPPPPPPPPPPPPPPPPPPPPPPPPPPPPPPPPPPPPPPPPPPPPPPPPPRRRPRRR
SSSSSSSSSSSSSSSSSSSSSSSSSSSSSSSSSSSSSPPPPPPPPPPPPPPPPPPPPPPPPPPPPPPPPPPPPPPPPPPPPPPPPPPPPPPPPPPPPPPPPPPPPPPPPPPPPPPPPRRRPRRRPRRR
SSSSSSSSSSSSSSSSSSSSSSSSSSSSPPPPPPPPPPPPPPPPPPPPPPPPPPPPPPPPPPPPPPPPPPPPPPPPPPPPPPPPPPPPPPPPPPPPPPPPPPPPPPPPPPPPPPPPPPPPPPPPPPPR
SSSSSSSSSPPPPPPPPPPPPPPPPPPPPPPPPPPPPPPPPRPRPRRRPRRRPRRRPRRRPRRRPRRRPRRRPRRRPRRRPRRRPRRRPRRRPRRRPRRRPRRRPRRRPRRRPRRRPRRRPRRRPRRR
SSPPPPPPPPPPPPPPPPPPPPPRPRRRPRRRPRRRPRRRPRRRPRRRPRRRPRRRPRRRPRRRPRRRPRRRPRRRPRRRPRRRPRRRPRRRPRRRPRRRPRRRPRRRPRRRPRRRPRRRPRRRPRRR
SSSSSSSSSSSSSSPPPPPRPRRRPRRRPRRRPRRRPRRRPRRRPRRRPRRRPRRRPRRRPRRRPRRRPRRRPRRRPRRRPRRRPRRRPRRRPRRRPRRRPRRRPRRRPRRRPRRRPRRRPRRRPRRR
SSSSSSSSSSSSSSSSSSSSSSSSSSPPPPPPPPPPPPPPPPPPPPPPPPPPPPPPPPPPPPPRPRRRPRRRPRRRPRRRPRRRPRRRPRRRPRRRPRRRPRRRPRRRPRRRPRRRPRRRPRRRPRRR
SSSSSSSSSSSSSSSSSSPPPPPPPPPPPPPPPPPPPPPPPRPRPRRRPRRRPRRRPRRRPRRRPRRRPRRRPRRRPRRRPRRRPRRRPRRRPRRRPRRRPRRRPRRRPRRRPRRRPRRRPRRRPRRR
SSSSSSSSSSPPPRRRPRRRPRRRPRRRPRRRPRRRPRRRPRRRPRRRPRRRPRRRPRRRPRRRPRRRPRRRPRRRPRRRPRRRPRRRPRRRPRRRPRRRPRRRPRRRPRRRPRRRPRRRPRRRPRRR
SPPRPRRRPRRRPRRRPRRRPRRRPRRRPRRRPRRRPRRRPRRRPRRRPRRRPRRRPRRRPRRRPRRRPRRRPRRRPRRRPRRRPRRRPRRRPRRRPRRRPRRRPRRRPRRRPRRRPRRRPRRRPRRR
SSSSSSSSSSPPPPPPPPPPPPPPPPPPPPPRPRRRPRRRPRRRPRRRPRRRPRRRPRRRPRRRPRRRPRRRPRRRPRRRPRRRPRRRPRRRPRRRPRRRPRRRPRRRPRRRPRRRPRRRPRRRPRRR
SSSSSSSSSSSSSSPPPPPPPPPPPPPPPPPPPPPPPPPPPPPPPPPPPRPRPRRRPRRRPRRRPRRRPRRRPRRRPRRRPRRRPRRRPRRRPRRRPRRRPRRRPRRRPRRRPRRRPRRRPRRRPRRR
SSSSSSSSSSSSSSSSSSSSSSSSSSSSSSSSSPPPPPPPPPPPPPPPPPPPPPPPPPPPPPPPPPPPPPPPPPPPPPPPPPPPPRRRPRRRPRRRPRRRPRRRPRRRPRRRPRRRPRRRPRRRPRRR
SSSSSSSSSSSSSSSSSSSSSSSSSSSPPPPPPPPPPPPPPRRRPRRRPRRRPRRRPRRRPRRRPRRRPRRRPRRRPRRRPRRRPRRRPRRRPRRRPRRRPRRRPRRRPRRRPRRRPRRRPRRRPRRR
SSSSSSPPPPPPPPPPPPPPPPPPPRPRPRRRPRRRPRRRPRRRPRRRPRRRPRRRPRRRPRRRPRRRPRRRPRRRPRRRPRRRPRRRPRRRPRRRPRRRPRRRPRRRPRRRPRRRPRRRPRRRPRRR
SSSSSSSSPPPPPPPPPPPPPPPRPRRRPRRRPRRRPRRRPRRRPRRRPRRRPRRRPRRRPRRRPRRRPRRRPRRRPRRRPRRRPRRRPRRRPRRRPRRRPRRRPRRRPRRRPRRRPRRRPRRRPRRR
SSSSSSSSSSSSSSSSSSSSSSSSSSSSSSSSSSSSSSSSSSSSSSSSSSSSSSSSSSSSSSSSSSSSSSSSSSSSSSSSSSSSSSSSSSSSSPPPPPPPPRPRPRRRPRRRPRRRPRRRPRRRPRRR
SSSSSSSSSSSSSSSSSSSSSSSSSSSSSSSSSSSPPPPPPPPPPPPPPPPPPPPRPRRRPRRRPRRRPRRRPRRRPRRRPRRRPRRRPRRRPRRRPRRRPRRRPRRRPRRRPRRRPRRRPRRRPRRR
SSSSSSSSSSSSSSSSSSSSSPPRPRRRPRRRPRRRPRRRPRRRPRRRPRRRPRRRPRRRPRRRPRRRPRRRPRRRPRRRPRRRPRRRPRRRPRRRPRRRPRRRPRRRPRRRPRRRPRRRPRRRPRRR
SSSSSSSSSSSSSSSSSSSSSSSPPPPPPPPPPPPPPPPPPPPPPPPPPPPPPPPPPPPPPPPPPPPPPPPPPPPPPPPPPPPPPPPPPPPPPPPPPPPPPPPPPPPPPPPPPPPRPRRRPRRRPRRR
SSSSSSSSPPPPPRRRPRRRPRRRPRRRPRRRPRRRPRRRPRRRPRRRPRRRPRRRPRRRPRRRPRRRPRRRPRRRPRRRPRRRPRRRPRRRPRRRPRRRPRRRPRRRPRRRPRRRPRRRPRRRPRRR
SSSSPPPPPPPPPPPPPPPPPPPPPPPPPPPPPPPPPPPPPPPPPPPPPPPPPPPPPPPPPPPPPPPPPPPPPPPPPPPPPPPPPPPPPPPPPPPPPPPPPPPPPPPPPPPPPPPPPPPPPRRRPRRR
SSSSSSSSPPPPPPPPPPPPPRPRPRRRPRRRPRRRPRRRPRRRPRRRPRRRPRRRPRRRPRRRPRRRPRRRPRRRPRRRPRRRPRRRPRRRPRRRPRRRPRRRPRRRPRRRPRRRPRRRPRRRPRRR
SSPPPPPPPPPPPPPPPPPPPPPPPPPPPPPPPPPPPPPPPPPPPPPPPPPPPPPPPPPRPRRRPRRRPRRRPRRRPRRRPRRRPRRRPRRRPRRRPRRRPRRRPRRRPRRRPRRRPRRRPRRRPRRR
SSSSSSSPPPPPPPPPPPPPPPPPPPPPPPPPPPPPPPPPPPPPPPPPPRRRPRRRPRRRPRRRPRRRPRRRPRRRPRRRPRRRPRRRPRRRPRRRPRRRPRRRPRRRPRRRPRRRPRRRPRRRPRRR
SSSSSSSSSSSSSSSSSSSSSSSSPPPPPPPPPPPPPPPPPPPPPPPPPPPPPPPPPPPPPPPPPPPPPRPRPRRRPRRRPRRRPRRRPRRRPRRRPRRRPRRRPRRRPRRRPRRRPRRRPRRRPRRR
SSSSSSSSSSSSSSSSSSSSSSSSSSSSSSSPPPPPPPPPPPPPPPPPPPPPPPPPPPPPPPPPPPPPPPPPPPPPPPPPPPPPPPPPPPPRPRRRPRRRPRRRPRRRPRRRPRRRPRRRPRRRPRRR
SSSSSSSSSSSSSSSSSSPPPPPPPPPPPPPPPPPPPPPPPPPPPPPPPPPPPPPRPRRRPRRRPRRRPRRRPRRRPRRRPRRRPRRRPRRRPRRRPRRRPRRRPRRRPRRRPRRRPRRRPRRRPRRR
SSSSSSSSSSSSSSSSSSSSSSSSPPPPPPPPPPPPPPPPPPPPPPPPPPPPPPPPPPPPPPPPPPPPPPPPPPPPPPPPPPPPPPPPPPPPPPPPPPPPPPPPPPPPPPPPPPPPPPPPPPPPPRPR
SSSSSSSSSSSSSSSSSSSPPPPPPPPPPPPPPPPPPPPPPPPPPPPPPPPPPPPPPPPPPPPPPPPPPPPPPPPPPPPPPPPPPPPPPRPRPRRRPRRRPRRRPRRRPRRRPRRRPRRRPRRRPRRR
SSSSSSSSSSPPPPPPPPPPPPPPPPPPPPPPPPPPPPPPPPPPPPPPPPPPPPPPPPPPPPPPPPPPPPPPPPPRPRRRPRRRPRRRPRRRPRRRPRRRPRRRPRRRPRRRPRRRPRRRPRRRPRRR
SSSSSSSSSSSSSSSSSSSSSSSSSSSSSSSSPPPPPPPPPRPRPRRRPRRRPRRRPRRRPRRRPRRRPRRRPRRRPRRRPRRRPRRRPRRRPRRRPRRRPRRRPRRRPRRRPRRRPRRRPRRRPRRR
SSSSSSSSSSSSSSSSSSSSSSSSSSSSSSSSSSSSSSSSSSPPPPPPPPPPPRPRPRRRPRRRPRRRPRRRPRRRPRRRPRRRPRRRPRRRPRRRPRRRPRRRPRRRPRRRPRRRPRRRPRRRPRRR
SSSSSSSSSSSSSPPPPPPPPPPPPPPPPPPPPPPPPPPPPPPPPPPPPPPPPPPPPPPPPPPPPPPPPPPPPPPPPPPPPPPPPPPPPPPPPPPPPPPPPPPPPRRRPRRRPRRRPRRRPRRRPRRR
SSSSSSSSSSSSSSSSSSSSSSSSSSSSSSSSSSSSSSSSSSPPPPPPPPPPPPPPPPPPPPPPPPPPPPPPPPPPPPPPPPPPPPPPPPPPPPPPPPPPPPPPPRRRPRRRPRRRPRRRPRRRPRRR
SSPPPPPPPPPPPPPPPPPPPPPPPPPPPPPPPPPPPPPPPPPPPPPPPPPPPPPPPPPPPPPRPRRRPRRRPRRRPRRRPRRRPRRRPRRRPRRRPRRRPRRRPRRRPRRRPRRRPRRRPRRRPRRR
SSSSSSSSSSSSSSSSSSSSSPPPPPPPPPPPPRPRPRRRPRRRPRRRPRRRPRRRPRRRPRRRPRRRPRRRPRRRPRRRPRRRPRRRPRRRPRRRPRRRPRRRPRRRPRRRPRRRPRRRPRRRPRRR
SSSSSSSSSSSSSSSSSSSSSSSSSSSSSSSSSSSSSSSSSSSPPPPPPPPPPPPPPPPPPPPPPRPRPRRRPRRRPRRRPRRRPRRRPRRRPRRRPRRRPRRRPRRRPRRRPRRRPRRRPRRRPRRR
SSSSSSSSSSSSSSSSSSSSSSSSSPPPPPPPPPPPPPPPPPPPPPPPPPPPPPPPPPPPPPPPPRRRPRRRPRRRPRRRPRRRPRRRPRRRPRRRPRRRPRRRPRRRPRRRPRRRPRRRPRRRPRRR
SSSSSSPPPPPPPPPPPPPPPRRRPRRRPRRRPRRRPRRRPRRRPRRRPRRRPRRRPRRRPRRRPRRRPRRRPRRRPRRRPRRRPRRRPRRRPRRRPRRRPRRRPRRRPRRRPRRRPRRRPRRRPRRR
SSSSSSSSSSSSPPPPPPPPPPPPPPPRPRRRPRRRPRRRPRRRPRRRPRRRPRRRPRRRPRRRPRRRPRRRPRRRPRRRPRRRPRRRPRRRPRRRPRRRPRRRPRRRPRRRPRRRPRRRPRRRPRRR
SSSSSSSSSSSSSSSSSSSSPPPPPPPPPPPPPPPPPPPPPPPPPPPPPPPPPPPPPPPPPPPPPPPPPPPPPPPPPPPPPPPPPPPPPPPPPPPPPRRRPRRRPRRRPRRRPRRRPRRRPRRRPRRR
SSSSSSSSSSSSSSSSSSSSSSSPPPPPPPPPPPPPPPPPPPPPPPPPPPPPPPPPPPPPPPPPPPPPPPPPPPPPPPPPPPPPPPPPPPPPPPPPPPPPPPPPPPPPPRRRPRRRPRRRPRRRPRRR
SSSSSSSSSSSSSSSSSSSSSSSSSSSSSSSSSSSSSSSSSSSSSSSSSSSSSSSSSSSSSSSSSSSSSSSSSSSSSSSPPPPPPPPPPPPPPPPPPPPPPPPPPPPPPPPPPRRRPRRRPRRRPRRR
SSSSSSSSSSSSSSSSSSSSSSSSSSSSSSSSSSSSSSSSSSSSSSSSSSSSSSSSSSSSSSSSSSSSSSSSSSSSSSSSSSSSSSSSSSSSSSSSSSSSSPPPPPPRPRRRPRRRPRRRPRRRPRRR
SSSSSSSSSSSSSSSSSSSSSSSSSSSSSSSSSSSSSSPPPPPPPPPPPPPPPPPPPPPPPPPPPRPRPRRRPRRRPRRRPRRRPRRRPRRRPRRRPRRRPRRRPRRRPRRRPRRRPRRRPRRRPRRR
SSSSSSSSSSSSSSSSSSSSSSSSSSSSSPPPPPPPPPPPPRPRPRRRPRRRPRRRPRRRPRRRPRRRPRRRPRRRPRRRPRRRPRRRPRRRPRRRPRRRPRRRPRRRPRRRPRRRPRRRPRRRPRRR
SSSSSSSSSSSSSSSSSSSSSSSSSSSSSSSSSSSSSSSSSSSSSSSSPPPPPPPPPPPPPPPPPPPPPPPPPPPPPPPPPPPPPPPPPPPPPPPPPPPPPPPPPPPPPPPPPPPPPPPPPPPPPRPR
SSSSSSSSSSSSSSSSSSSSSSSPPRPRPRRRPRRRPRRRPRRRPRRRPRRRPRRRPRRRPRRRPRRRPRRRPRRRPRRRPRRRPRRRPRRRPRRRPRRRPRRRPRRRPRRRPRRRPRRRPRRRPRRR
SSSSSSSSSSSSSSSSSSSSSSSSSSSSSSSSSSSSSSSSPPPPPPPPPPPPPPPPPPPPPPPPPPPPPPPPPPPPPPPPPPPRPRRRPRRRPRRRPRRRPRRRPRRRPRRRPRRRPRRRPRRRPRRR
SSSSSSSSSSSSSSSSSSSSSSSSSPPPPPPPPPPRPRRRPRRRPRRRPRRRPRRRPRRRPRRRPRRRPRRRPRRRPRRRPRRRPRRRPRRRPRRRPRRRPRRRPRRRPRRRPRRRPRRRPRRRPRRR
SSSSSSSSSSSSSSSSSSSSSSSSSSSSSSSSSSSSSSSSSSSSSSSSSSSSSSSSSSSSSSSSSSPPPPPPPPPPPPPPPPPPPPPPPPPPPPPPPPPPPPPPPPPPPPPPPPPPPRPRPRRRPRRR
SSSSSSSSSSSSSSSSSSSSSSSSSSSSSSSSSSSSSSSSSPPPPPPPPPPPPPPPPPPPPPPPPPPRPRRRPRRRPRRRPRRRPRRRPRRRPRRRPRRRPRRRPRRRPRRRPRRRPRRRPRRRPRRR
SSSSSSSSSSSSSSSSSSSSSSSSSSSSSSSSSSSSSSSSPPPPPPPPPPPPPPPPPPPPPPPPPPPPPPPPPPPPPPPPPPPPPPPPPPPPPPPPPPPPPPPPPPPPPPPPPPPRPRRRPRRRPRRR
SSSSSSSSSSSSSSSSSSSSSSSSSSSSSSSSSSSSSSSSSSSSSSSSSSSSSSSSSSSSSPPPPPPPPPPPPPPPPPPPPPPPPPPPPPPPPRPRPRRRPRRRPRRRPRRRPRRRPRRRPRRRPRRR
SSPPPRRRPRRRPRRRPRRRPRRRPRRRPRRRPRRRPRRRPRRRPRRRPRRRPRRRPRRRPRRRPRRRPRRRPRRRPRRRPRRRPRRRPRRRPRRRPRRRPRRRPRRRPRRRPRRRPRRRPRRRPRRR
SSSSSSSSSSSSSSSSSSSSSSSSSSSPPPPPPPPPPPPPPPPPPPPPPPPPPPPPPPPPPPPPPPPPPPPPPPPPPPPPPPPRPRRRPRRRPRRRPRRRPRRRPRRRPRRRPRRRPRRRPRRRPRRR
SSSSPPPPPPPPPPPPPPPPPPPPPPPPPPPPPPPPPPPPPPPPPPPPPPPPPPPPPPPPPPPPPPPPPPPPPPPPPPPPPPPPPPPRPRRRPRRRPRRRPRRRPRRRPRRRPRRRPRRRPRRRPRRR
SSSSSSSSPPPRPRRRPRRRPRRRPRRRPRRRPRRRPRRRPRRRPRRRPRRRPRRRPRRRPRRRPRRRPRRRPRRRPRRRPRRRPRRRPRRRPRRRPRRRPRRRPRRRPRRRPRRRPRRRPRRRPRRR
SSSSSSSSSSSSSSSSSSSSSSSSSSSSSSSSSSSSSSSSSSSPPPPPPPPPPPPPPPPPPPPPPPPPPPPPPPPPPPPPPPPPPPPPPPPPPRRRPRRRPRRRPRRRPRRRPRRRPRRRPRRRPRRR
SSSSSSSSSSPPPPPPPPPPPPPPPPPPPPPPPPPPPPPPPPPPPPPPPPPPPPPPPPPPPPPPPPPPPPPPPPPPPRPRPRRRPRRRPRRRPRRRPRRRPRRRPRRRPRRRPRRRPRRRPRRRPRRR
SSSSSSSSSSSSSSSSSSSSSSSSSSSSSSSSSSSSSSSSPPPPPPPPPPPPPPPPPPPPPPPPPPPPPPPPPPPPPPPPPPPPPPPPPPPPPPPPPPPPPPPPPRRRPRRRPRRRPRRRPRRRPRRR
SSSSSSSSSSSSSSSSSSSSSSSSSSSSSSSSSSSSSSSSSSSSSSSSSSSSSSSSSSSSSSSSSSSSSSSSSSSSSSPPPPPPPPPPPPPPPRRRPRRRPRRRPRRRPRRRPRRRPRRRPRRRPRRR
SSSSSSSSPPPPPPPPPPPPPRRRPRRRPRRRPRRRPRRRPRRRPRRRPRRRPRRRPRRRPRRRPRRRPRRRPRRRPRRRPRRRPRRRPRRRPRRRPRRRPRRRPRRRPRRRPRRRPRRRPRRRPRRR
SSSSSSSSSPPPPPPPPPPPPPPPPPPPPPPPPRPRPRRRPRRRPRRRPRRRPRRRPRRRPRRRPRRRPRRRPRRRPRRRPRRRPRRRPRRRPRRRPRRRPRRRPRRRPRRRPRRRPRRRPRRRPRRR
SSSSSSSSSSSSSSSSSSSSSSSSSSSSSSSSSSSSSSSSSSPPPPPPPRRRPRRRPRRRPRRRPRRRPRRRPRRRPRRRPRRRPRRRPRRRPRRRPRRRPRRRPRRRPRRRPRRRPRRRPRRRPRRR
SSSSSSSSSSSSSSSSSSSSSSSSSSSSSSSSSSSSSSSSSSSSSSSSSSSSSRPRPRRRPRRRPRRRPRRRPRRRPRRRPRRRPRRRPRRRPRRRPRRRPRRRPRRRPRRRPRRRPRRRPRRRPRRR
SSSSSSSSSSSPPPPPPPPPPPPPPPPPPPPPPPPPPPPPPPPPPPPPPPPPPPPPPPPPPPPPPPPPPPPPPPPPPPPPPPPPPPPPPPPPPPPPPRRRPRRRPRRRPRRRPRRRPRRRPRRRPRRR
SSSSSSSSSSSSSSSSSSSSSPPPPPPPPPPPPPPPPPPPPPPPPPPPPPPPPPPPPPPPPRPRPRRRPRRRPRRRPRRRPRRRPRRRPRRRPRRRPRRRPRRRPRRRPRRRPRRRPRRRPRRRPRRR
SSSSSSSSSSSSSSSSSSSSSSSSSSSSSSSSSPPPPPPPPPPPPPPPPPPPPPPPPPPRPRRRPRRRPRRRPRRRPRRRPRRRPRRRPRRRPRRRPRRRPRRRPRRRPRRRPRRRPRRRPRRRPRRR
SSSSSSSSSSSSSSSSSSSSSSSSSSSSSSSSSSSSSSSSSSSSSSSSSSPPPRRRPRRRPRRRPRRRPRRRPRRRPRRRPRRRPRRRPRRRPRRRPRRRPRRRPRRRPRRRPRRRPRRRPRRRPRRR
SPPPPRRRPRRRPRRRPRRRPRRRPRRRPRRRPRRRPRRRPRRRPRRRPRRRPRRRPRRRPRRRPRRRPRRRPRRRPRRRPRRRPRRRPRRRPRRRPRRRPRRRPRRRPRRRPRRRPRRRPRRRPRRR
SSSSSSSSSSSSSSSSSSSSSSSSSSSSSSSSSSSSSSSSSSSSSSSSSSSSSSSSPPPPPPPPPRRRPRRRPRRRPRRRPRRRPRRRPRRRPRRRPRRRPRRRPRRRPRRRPRRRPRRRPRRRPRRR
SSSSSSSSSSSSSSSSSSSSSSSSSSPPPPPPPPPPPPPPPPPPPPPPPRPRPRRRPRRRPRRRPRRRPRRRPRRRPRRRPRRRPRRRPRRRPRRRPRRRPRRRPRRRPRRRPRRRPRRRPRRRPRRR
SSPPPPPPPPPPPPPPPPPPPPPPPPPPPPPPPPPPPPPPPPPPPPPPPPPPPPPPPPPPPPPPPPPPPPPPPRRRPRRRPRRRPRRRPRRRPRRRPRRRPRRRPRRRPRRRPRRRPRRRPRRRPRRR
SSSSSSSSSSSSSSSSSSSSSSSSSSSSSSSSSSSSSSSSSSSSSSSSSSSSSSSPPPPPPPPPPPPPPPPRPRRRPRRRPRRRPRRRPRRRPRRRPRRRPRRRPRRRPRRRPRRRPRRRPRRRPRRR
SSSSSSSSSSSSSPPPPPPPPPPPPPPPPPPPPPPPPPPPPPPPPPPPPPPPPPPPPPPPPPPPPPPPPPPPPPPPPPPPPPPPPPPPPPPPPPPPPPPPPPPPPRRRPRRRPRRRPRRRPRRRPRRR
SSSSSSSSSSSSSSSSSSSSSSSSSSSSSSSSSSSSSSSSSSSSSSSSSSSSSSSSSSSSSSSSSSSSSSSSSSPPPPPPPPPPPPPRPRRRPRRRPRRRPRRRPRRRPRRRPRRRPRRRPRRRPRRR
SSSSSSSSSSSSSSSSSSSSSSSSSSSSSSPPPPPPPPPRPRRRPRRRPRRRPRRRPRRRPRRRPRRRPRRRPRRRPRRRPRRRPRRRPRRRPRRRPRRRPRRRPRRRPRRRPRRRPRRRPRRRPRRR
SSSSSSSSSSSSSSSSSSSSSSSSSSSSSSSSSSSSSSSSSSSSSSSPPPPPPPPPPPPPPPPPPPPPPPPPPPPPPPPPPPPPPPPPPPPPPPPPPPPPPPPPPPPPPPPRPRRRPRRRPRRRPRRR
SSSSSSSSSSSSSPPPPPPPPPPPPPPPPPPPPPPPPPPPPPPPPPPPPPPPPPPPPPPPPPPPPPPPPPPPPPPPPPPPPPPPPPPPPPPPPPPPPPPPPPPPPRRRPRRRPRRRPRRRPRRRPRRR
SSSSSSSSSSSSSSSSSSSSSSSSSSSSSSSSSSSPPPPPPRPRPRRRPRRRPRRRPRRRPRRRPRRRPRRRPRRRPRRRPRRRPRRRPRRRPRRRPRRRPRRRPRRRPRRRPRRRPRRRPRRRPRRR
SSSSSSSSSSSSSSSSSPPPPPPPPPPPPPPPPPPPPPPPPPPPPPPPPPPPPPPPPPPPPPPPPPPPPPPPPPPPPPPPPPPPPPPPPPPPPPPPPRPRPRRRPRRRPRRRPRRRPRRRPRRRPRRR
SSPPPPPPPPPPPPPPPPPPPPPPPPPPPPPPPPPPPPPPPPPPPPPPPRPRPRRRPRRRPRRRPRRRPRRRPRRRPRRRPRRRPRRRPRRRPRRRPRRRPRRRPRRRPRRRPRRRPRRRPRRRPRRR
SSSSSSSSSSSSSSPRPRRRPRRRPRRRPRRRPRRRPRRRPRRRPRRRPRRRPRRRPRRRPRRRPRRRPRRRPRRRPRRRPRRRPRRRPRRRPRRRPRRRPRRRPRRRPRRRPRRRPRRRPRRRPRRR
SSSSSSSPPPPPPPPPPPPPPRPRPRRRPRRRPRRRPRRRPRRRPRRRPRRRPRRRPRRRPRRRPRRRPRRRPRRRPRRRPRRRPRRRPRRRPRRRPRRRPRRRPRRRPRRRPRRRPRRRPRRRPRRR
SSSSSSSSSSSSSSSPPPPPPPPPPPPRPRRRPRRRPRRRPRRRPRRRPRRRPRRRPRRRPRRRPRRRPRRRPRRRPRRRPRRRPRRRPRRRPRRRPRRRPRRRPRRRPRRRPRRRPRRRPRRRPRRR
