SSSSSSSSSSSSSSSSSSSSSSSSSSSSSSSSSSSSSSSSSSSSSSSSSSSSSSSSSSPPPPPPPPPRPRRRPRRRPRRRPRRRPRRRPRRRPRRRPRRRPRRRPRRRPRRRPRRRPRRRPRRRPRRR
SSSSSSSSSSSSSSSSSSSSSSSSSSPPPPPPPPPPPPPPPPPPPPPPPPPPPPPPPPPPPPPPPRRRPRRRPRRRPRRRPRRRPRRRPRRRPRRRPRRRPRRRPRRRPRRRPRRRPRRRPRRRPRRR
SSSSSSSSSSSSSSSSSSSSSSSSSSSSSSSSSSSSSSSSSSSSSSSSSSSSSSSSSPPPPPPPPPPPPRPRPRRRPRRRPRRRPRRRPRRRPRRRPRRRPRRRPRRRPRRRPRRRPRRRPRRRPRRR
SSSSSSSSSSSSSSSSSSSSSSSSSSSSSSSSSSSSSSSSSSSSSSSSPPPPPPPPPPPPPPPPPPPPPPPPPPPPPPPPPPPPPPPPPPPPPRRRPRRRPRRRPRRRPRRRPRRRPRRRPRRRPRRR
SSSSSSSSSSSSSSSSSSSSSSSSSSSSSSSSSSSSSSSSPPPPPPPPPPPPPPPPPPPPPPPPPRRRPRRRPRRRPRRRPRRRPRRRPRRRPRRRPRRRPRRRPRRRPRRRPRRRPRRRPRRRPRRR
SSSSSSSSSSSSSSSSSPPPPRRRPRRRPRRRPRRRPRRRPRRRPRRRPRRRPRRRPRRRPRRRPRRRPRRRPRRRPRRRPRRRPRRRPRRRPRRRPRRRPRRRPRRRPRRRPRRRPRRRPRRRPRRR
SSSSSSSSSSSSSSSSSSSSSSSSSSSSSSSSSSSSSSSSSSSSSSSSSSSSSSSSSSSSSSSSSSSSSSSSSSSSSSSSSSSSSSSSSPPPPPPPPPPPPPPPPPPPPPPPPPPPPPPPPPPRPRRR
SSSSSSSSSSSSSSSSSSSSSSSSSSSPPPPPPPPPPPPPPPPPPPPPPPPPPPPPPRRRPRRRPRRRPRRRPRRRPRRRPRRRPRRRPRRRPRRRPRRRPRRRPRRRPRRRPRRRPRRRPRRRPRRR
SSSSSSSSSSSPPPPPPPPPPPPPPPPPPPPPPPPPPPPPPPPPPPPPPPPPPPPPPPPPPPPPPPPPPPPPPPPPPPPPPPPPPPPPPPPPPPPPPPPPPPPPPPPPPPPPPPPPPPPPPRRRPRRR
SSSSSSSSPPPPPPPPPPPPPPPPPPPPPPPPPPPPPPPPPPPPPPPPPPPPPPPPPPPPPPPPPPPPPPPPPPPPPPPPPPPPPRRRPRRRPRRRPRRRPRRRPRRRPRRRPRRRPRRRPRRRPRRR
SSSSSSSSSSSSSSSSSSSSSSSSSSSSSSSSSSSSSSSSSSSSSSSSSSSSSSSSSSSSSPPPPPPPPRPRPRRRPRRRPRRRPRRRPRRRPRRRPRRRPRRRPRRRPRRRPRRRPRRRPRRRPRRR
SSSSSSSSSSSSSSSSSSSSSSSSSSSSSSSSPPPPPPPPPPPPPPPPPPPPPPPPPRPRPRRRPRRRPRRRPRRRPRRRPRRRPRRRPRRRPRRRPRRRPRRRPRRRPRRRPRRRPRRRPRRRPRRR
SSSSSSSSSSSSSSSSSSSSSSSSSSSSSSSSSSSSSSSSSSSSSSSSSSSSSSSSSSSSSSSSSSSSSSSPPPPPPPPPPPPPPPPPPPPPPPPPPPPPPPPRPRRRPRRRPRRRPRRRPRRRPRRR
SSSSSSSSSSSSSSSSSSSSSSSSSSSSSSSSSSSSSSSSSSSSSSSSSSSSSSSSSSSSSSPPPPPPPPPPPPPPPPPPPPPPPPPPPPPPPPPRPRRRPRRRPRRRPRRRPRRRPRRRPRRRPRRR
SSSSSSSSSSSSSSSSSSSSSSSSSSSSSSSSSSSSSSSSSSSSSSPPPPPPPPPPPPPPPPPPPPPPPPPPPPPPPPPPPPPPPPPPPPPPPPPPPPPPPPPPPPPRPRRRPRRRPRRRPRRRPRRR
SSSSSSSSSSPPPPPPPPPPPPPPPPPPPPPPPPPPPPPPPPPPPPPPPPPPPPPPPPPPPPPPPPPPPRRRPRRRPRRRPRRRPRRRPRRRPRRRPRRRPRRRPRRRPRRRPRRRPRRRPRRRPRRR
SSSSPPPPPPPPPPPPPPPPPPPPPPPPPPPPPPPPPPPPPPPPPPPPPPPPPPPPPPPPPPPPPPPPPPPPPPPPPPPPPPPPPPPPPPPPPPPPPPPPPPPPPPPPPPPPPPPPPPPPPRRRPRRR
SSSSSSSSSSSSSSSPPPPPPPPPPPPRPRRRPRRRPRRRPRRRPRRRPRRRPRRRPRRRPRRRPRRRPRRRPRRRPRRRPRRRPRRRPRRRPRRRPRRRPRRRPRRRPRRRPRRRPRRRPRRRPRRR
SSSSSSSSSSSSSSSSSSSSSSSSSSSSSSSSSSSSSSSSSSSSSSSSSSSSSSSSSSSSSSSSSSSSPPPPPPPPPPPPPPPPPPPPPPPPPPPPPPPPPPPPPPPPPPPPPPPPPPPPPPPRPRRR
SSSSSSSSSSSSSSSSSSSSSSSSSSSSSSSSSSSSSSSSSSSSSSSSSSSSSPPPPPPPPPPPPPPPPPPPPRRRPRRRPRRRPRRRPRRRPRRRPRRRPRRRPRRRPRRRPRRRPRRRPRRRPRRR
SSSSSSSSSSSSSSSSSSSSSSSSSSSSSSSSSSSSSSSSSSSSSSSSSSSSSSSSSSSSSSSSSSSSSSSSSSPPPPPPPPPPPRRRPRRRPRRRPRRRPRRRPRRRPRRRPRRRPRRRPRRRPRRR
SSSSSSSSSSSSSSSSSSSSSSSSSSSSSSSSPPPPPPPPPPPPPRPRPRRRPRRRPRRRPRRRPRRRPRRRPRRRPRRRPRRRPRRRPRRRPRRRPRRRPRRRPRRRPRRRPRRRPRRRPRRRPRRR
SSSSSSSSSSSSSSSSSSSSSSSSSSSSSSSSPPPPPPPPPPPPPPPPPPPPPPPPPPPPPPPPPPPPPPPPPPPPPPPPPPPPPPPPPPPPPPPPPPPPPPPPPPPPPPPPPPPPPPPPPRPRPRRR
SSSSSSSSSSSSSSSSSSSSSSSSSSSSSPPPPPPPPPPPPPPPPPPPPPPPPPPPPPPPPPPPPPPPPPPPPPPPPPPPPPPPPPPPPPPPPPPPPPPPPPPPPRPRPRRRPRRRPRRRPRRRPRRR
SSSSSSSSSSSSSSSSSSSSSSSSSSSSSSSSSSSSSSSSSSSSSSSSSSSSSSSSSSSSSSSSSSSSSPPPPPPPPPPPPPPPPPPPPPPPPPPPPPPPPPPPPPPPPPPPPRRRPRRRPRRRPRRR
SSSSSSSSSSSSSSSSSPPPPPPPPPPPPPPPPPPPPPPPPPPPPRPRPRRRPRRRPRRRPRRRPRRRPRRRPRRRPRRRPRRRPRRRPRRRPRRRPRRRPRRRPRRRPRRRPRRRPRRRPRRRPRRR
SSSSSSSSSSSSSSSSSSSSSSSSSPPPPPPPPPPPPPPPPPPPPRRRPRRRPRRRPRRRPRRRPRRRPRRRPRRRPRRRPRRRPRRRPRRRPRRRPRRRPRRRPRRRPRRRPRRRPRRRPRRRPRRR
SSSSSSSSSSSSSSSSSSSSSSSSSSSSPPPPPPPPPRPRPRRRPRRRPRRRPRRRPRRRPRRRPRRRPRRRPRRRPRRRPRRRPRRRPRRRPRRRPRRRPRRRPRRRPRRRPRRRPRRRPRRRPRRR
SSSSSSSSSSSSSSSSSSSSSSSSSSSSSSSSSSSSSSSSSSSPPPPPPPPPPRPRPRRRPRRRPRRRPRRRPRRRPRRRPRRRPRRRPRRRPRRRPRRRPRRRPRRRPRRRPRRRPRRRPRRRPRRR
SSSSSSSSSSSSSSSSSSSSSSSSSSSSSSSSSSSSSSSSSSSSSSSSSSSSSSSSSSSSSSSSSSSSSSSSSSSSSSSSSSSSSSSSSSSSSSSSSSSPPPPPPPPPPPPPPRPRPRRRPRRRPRRR
SSSSSSSSSSPRPRRRPRRRPRRRPRRRPRRRPRRRPRRRPRRRPRRRPRRRPRRRPRRRPRRRPRRRPRRRPRRRPRRRPRRRPRRRPRRRPRRRPRRRPRRRPRRRPRRRPRRRPRRRPRRRPRRR
SSSSSSSSSSSSSSSSSSSSSSSSSSSSSSSSSSSSSSSSSSSSSSSSSSSSSSSSSSSSSSSSSSSSSSSSSSSSSSSSSSSSSSSSSSSSSSSSSSSSSSSPPRPRPRRRPRRRPRRRPRRRPRRR
SSSSSSSSSSSSSSSSSSSSSSSSSSSSSSSSSSSSSSSSSSSSSSSSSSSSSSSSSSSSSSSSSSSSSSSSSSSSSSSSSSSSSSSPPPPPPRRRPRRRPRRRPRRRPRRRPRRRPRRRPRRRPRRR
SSSSSSSSSSSSSSSSSSSSSSSSSSSSSSSSSSSSSSSSSSSSSSSSSSSSSSSSSSSSSSSSSSSSSPPPPPPPPPPPPPPPPPPPPPPPPPPRPRRRPRRRPRRRPRRRPRRRPRRRPRRRPRRR
SSSSSSSSSSSSSSSSSSSSSSSSSSSSSSSSSSSSSSSSSSSSSSPPPPPPPPPPPPPPPPPPPPPPPPPPPPPPPPPPPPPPPPPPPPPPPPPPPPPPPPPPPPPPPPPPPPPRPRRRPRRRPRRR
SSSSSSSSSSSSSSSSSSSSSPPPPPPPPPPPPPPPPPPPPPPPPPPPPPPPPPPPPPPPPPPPPPPPPPPPPPPPPPPPPPPPPRPRPRRRPRRRPRRRPRRRPRRRPRRRPRRRPRRRPRRRPRRR
SSSSSSSSSSSSSSSSSSSPPPPPPPPPPPPPPPPPPPPPPPPPPPPPPPPPPPPPPPPPPPPPPPPPPPPPPPPPPPPPPPPPPPPPPPPPPPPPPPPPPPPPPPPPPRRRPRRRPRRRPRRRPRRR
SSSSSSSSSSSSSSSSSSSSSSSSSSSSSSSSSSSSSSSSSSSSSSSSSSSSSSSSSSSSSSSSSPPPPPPPPPPPPPPPPPPPPPPPPPPPPRPRPRRRPRRRPRRRPRRRPRRRPRRRPRRRPRRR
SSSSSSSSSSSSSSSSSSSSSSSSSSSSSSSSSPPPPPPPPPPPPPPPPPPPPPPPPPPPPPPPPPPPPPPPPPPPPPPPPPPPPRRRPRRRPRRRPRRRPRRRPRRRPRRRPRRRPRRRPRRRPRRR
SSSSSSSSSSSSSSSSSSSSSSSSSSSSSSSSSSSSSSSSSSSSSSSSSSSSSSSSSSSSSSSSSSSSSSSSSSSSSSSSSSSSSSSSSSSSSSSSPPPPPPPPPPPPPPPPPRRRPRRRPRRRPRRR
SSSSSPPPPPPPPPPPPPPPPPPPPPPPPPPPPPPPPRPRPRRRPRRRPRRRPRRRPRRRPRRRPRRRPRRRPRRRPRRRPRRRPRRRPRRRPRRRPRRRPRRRPRRRPRRRPRRRPRRRPRRRPRRR
SSSSSSSSSSSSSSSSSSSSSSSSSSSSSSSSSSSSSSSSSSSSSSSSSSSSSSSSSSSSSSSSSSSSSSSSSPPPPPPPPPPPPPPPPPPPPPPPPPPPPPPPPPPPPPPPPPPPPPPRPRRRPRRR
SSSSPPPRPRRRPRRRPRRRPRRRPRRRPRRRPRRRPRRRPRRRPRRRPRRRPRRRPRRRPRRRPRRRPRRRPRRRPRRRPRRRPRRRPRRRPRRRPRRRPRRRPRRRPRRRPRRRPRRRPRRRPRRR
SSSSSSSSSSSSSSSSSSSSSSSSSSSSSSSSSSSSSSSSSSPPPPPPPPPPPPPPPPPPPPPPPPPPPPPPPPPPPPPPPRPRPRRRPRRRPRRRPRRRPRRRPRRRPRRRPRRRPRRRPRRRPRRR
SSSSSSSSSSSSSSSSSSSSSSSSSSSSSSSSSPPPPRRRPRRRPRRRPRRRPRRRPRRRPRRRPRRRPRRRPRRRPRRRPRRRPRRRPRRRPRRRPRRRPRRRPRRRPRRRPRRRPRRRPRRRPRRR
SSSSSSSSSSSSSSSSSSSPPPPPPPPPPPPPPPPPPPPPPPPPPPPPPRRRPRRRPRRRPRRRPRRRPRRRPRRRPRRRPRRRPRRRPRRRPRRRPRRRPRRRPRRRPRRRPRRRPRRRPRRRPRRR
SPPPPPPPPPPPPPPPPPPPPPPPPPPPPPPPPPPPPPPPPPPPPPPPPPPPPPPPPPPPPPPPPPPPPPPPPPPPPPPPPPPPPRPRPRRRPRRRPRRRPRRRPRRRPRRRPRRRPRRRPRRRPRRR
SSSSSSSSSSSSSSSSSSSSSSSSSSSSSSSSSSSSSSSSSSSSSSSSSSSSSSSSSSSSSSSSSSSSSSSSSSSSSSSSSSSSSSSSSSSSSSPPPPPPPPPPPPPPPPPPPPPRPRRRPRRRPRRR
SSSSSSSSSSSSSSSSSSSSSSSSSSSSSSSSSSSSSSSSSSSSSPPRPRRRPRRRPRRRPRRRPRRRPRRRPRRRPRRRPRRRPRRRPRRRPRRRPRRRPRRRPRRRPRRRPRRRPRRRPRRRPRRR
SSSSSSSSSSSSSSSSSSSSSSSSSSSSSSSSSSSSSSSSSSSSSSSSSSSSSSSSSSSPPPPPPPPPPPPPPPPPPPPPPPPPPPPPPPPPPPPPPPPPPPPPPPPPPPPPPPPPPPPPPPPRPRRR
SSSSSSSSSSSSSSSSSSSSSSSSSSSSSSSSSSSSSSSSSSSSSSSSSSSSSSSSSSSSSSSSSSSSSSSSSSSSSSSSSSSSSSSSPPPPPPPPPPPPPPPPPPPRPRRRPRRRPRRRPRRRPRRR
SSSSSSSSSSSSSSSSSSSSSSSSSSSSPPPPPPPPPPPPPPPPPRRRPRRRPRRRPRRRPRRRPRRRPRRRPRRRPRRRPRRRPRRRPRRRPRRRPRRRPRRRPRRRPRRRPRRRPRRRPRRRPRRR
SSSSSSSSSSSSSSSSSSSSPPPPPPPPPPPPPPPPPPPPPPPPPRRRPRRRPRRRPRRRPRRRPRRRPRRRPRRRPRRRPRRRPRRRPRRRPRRRPRRRPRRRPRRRPRRRPRRRPRRRPRRRPRRR
SSSSSSPRPRRRPRRRPRRRPRRRPRRRPRRRPRRRPRRRPRRRPRRRPRRRPRRRPRRRPRRRPRRRPRRRPRRRPRRRPRRRPRRRPRRRPRRRPRRRPRRRPRRRPRRRPRRRPRRRPRRRPRRR
SSPRPRRRPRRRPRRRPRRRPRRRPRRRPRRRPRRRPRRRPRRRPRRRPRRRPRRRPRRRPRRRPRRRPRRRPRRRPRRRPRRRPRRRPRRRPRRRPRRRPRRRPRRRPRRRPRRRPRRRPRRRPRRR
SSSSSSSSSSSSSSSSSSSSSSSSSSSSSSSSSSSSSSSSSSSSSSSSSSSSSSSSSSSSSSSSSSSSSSSSSSSSSSSSPPPPPPPPPPPPPPPPPPPPPPPPPPPPPPPPPPPPPPPPPPPPPRPR
SSSSSSSSSSSSSSSSSSSSSSSSSSSSSSSSSSSSSSSSSSSSSSSSSSSSSSSSSSSSSSSSSSSSSSPPPPPPPPPPPPPPPPPPPPPPPPPPPPPPPPPPPPPPPPPPPPPPPPPPPPPPPRPR
SSSSSSSSSSSSSSSSSSSSSSSSSSSSSSSSSSSSSSSSSSSSSSSSSSSSSSSSSSSSSSSSSSSSSSSSSSSPPPPPPPPPPPPPPPPPPPPPPPPPPPPPPPPPPRRRPRRRPRRRPRRRPRRR
SSSSSSSSSSSSSSSSSSSSSSSSSSSSSSSSSSSSSSSSPPPPPPPPPPPPPPPPPPPPPPPPPPPPPPPPPPPPPPPPPPPPPPPPPPPPPPPPPPPPPPPPPPPPPPPPPPPPPPPPPPPRPRRR
SSSSSPPPPPPPPPPPPPPPPPPPPPPRPRRRPRRRPRRRPRRRPRRRPRRRPRRRPRRRPRRRPRRRPRRRPRRRPRRRPRRRPRRRPRRRPRRRPRRRPRRRPRRRPRRRPRRRPRRRPRRRPRRR
SSSSPPPPPPPPPRRRPRRRPRRRPRRRPRRRPRRRPRRRPRRRPRRRPRRRPRRRPRRRPRRRPRRRPRRRPRRRPRRRPRRRPRRRPRRRPRRRPRRRPRRRPRRRPRRRPRRRPRRRPRRRPRRR
SSSSSSSSPPPPPPPPPPPPPPPPPPPPPPPPPPPPPPPPPPPPPPPPPPPPPRRRPRRRPRRRPRRRPRRRPRRRPRRRPRRRPRRRPRRRPRRRPRRRPRRRPRRRPRRRPRRRPRRRPRRRPRRR
SSSSSSSSSSSSSSSSSPPPPPPPPPPPPPPPPPPPPPPPPPPPPPPPPPPPPPPPPPPPPPPPPPPPPPPPPRRRPRRRPRRRPRRRPRRRPRRRPRRRPRRRPRRRPRRRPRRRPRRRPRRRPRRR
SSSSSSSSSSSSSSSSSSSSPPPPPPPPPPPPPPPPPPPPPPPPPPPPPRPRPRRRPRRRPRRRPRRRPRRRPRRRPRRRPRRRPRRRPRRRPRRRPRRRPRRRPRRRPRRRPRRRPRRRPRRRPRRR
SSSSSSSSSSSSSSSSSPPPPPPRPRRRPRRRPRRRPRRRPRRRPRRRPRRRPRRRPRRRPRRRPRRRPRRRPRRRPRRRPRRRPRRRPRRRPRRRPRRRPRRRPRRRPRRRPRRRPRRRPRRRPRRR
SSSSSSSSSSSSSRPRPRRRPRRRPRRRPRRRPRRRPRRRPRRRPRRRPRRRPRRRPRRRPRRRPRRRPRRRPRRRPRRRPRRRPRRRPRRRPRRRPRRRPRRRPRRRPRRRPRRRPRRRPRRRPRRR
SPPPPPPPPPPPPPPPPPPPPPPPPPPPPPPPPPPRPRRRPRRRPRRRPRRRPRRRPRRRPRRRPRRRPRRRPRRRPRRRPRRRPRRRPRRRPRRRPRRRPRRRPRRRPRRRPRRRPRRRPRRRPRRR
SSSSSSSSSSSSSSSSSSSSSSSSSSSSSSSSSSSSSSSSSSSSSSSSSSSSSSSSSSSSSSSSSSSSSSSSSSSSSSSSSSSSSSSSSSSSSSSSPPPPPPPPPPPPPPPPPRRRPRRRPRRRPRRR
SSSSSSSSSSSSSSSSSSSPPPPPPPPPPPPPPPPPPPPPPPPPPPPPPPPPPPPPPPPPPPPPPPPPPPPPPPPPPPPPPPPPPPPPPPPPPPPPPPPPPPPPPPPPPRPRPRRRPRRRPRRRPRRR
SSSSSSSSSSSSSSSSSSSSSSSSSSSSSSSSSSSSSSSSSSSSSSSSSSSSSSSSSSSSSSSSSSSSSSSSPPPPPPPPPPPPPPPPPPPPPRPRPRRRPRRRPRRRPRRRPRRRPRRRPRRRPRRR
SSSSSSSSSPPPPPPPPPPPPPPPPPPPPPPPPPPPPPPPPPPPPPPPPPPPPPPPPPPPPPPPPPPPPPPPPPPPPPPPPPPPPPPPPPPPPPPPPPPPPPPPPPPPPPPPPPPPPPPRPRRRPRRR
SSSSSSSSSSSSSSSSSSSSSSSSSSSSSSSSSSSSSSSSSSSSSSSSSPPPPRPRPRRRPRRRPRRRPRRRPRRRPRRRPRRRPRRRPRRRPRRRPRRRPRRRPRRRPRRRPRRRPRRRPRRRPRRR
SSSSSSSSSSSSSSSSSSSSSSSSSSSSSSSSSSSSSSSSSSSSSSSSSPPPPPPPPPPPPPPPPPPPPPPPPPPPPPPPPPPPPPPPPPPPPPPPPPPRPRRRPRRRPRRRPRRRPRRRPRRRPRRR
SSPRPRRRPRRRPRRRPRRRPRRRPRRRPRRRPRRRPRRRPRRRPRRRPRRRPRRRPRRRPRRRPRRRPRRRPRRRPRRRPRRRPRRRPRRRPRRRPRRRPRRRPRRRPRRRPRRRPRRRPRRRPRRR
SSSSSSSPPPPPPPPPPPPPPPPPPPPPPPPPPPPPPRRRPRRRPRRRPRRRPRRRPRRRPRRRPRRRPRRRPRRRPRRRPRRRPRRRPRRRPRRRPRRRPRRRPRRRPRRRPRRRPRRRPRRRPRRR
SSSSSSSSPPPPPPPPPPPPPPPPPPPPPPPPPPPPPPPPPPPPPPPPPPPPPPPPPPPPPPPRPRRRPRRRPRRRPRRRPRRRPRRRPRRRPRRRPRRRPRRRPRRRPRRRPRRRPRRRPRRRPRRR
SSSSSSSSSSSSSSSSSSSSSSPPPPPPPPPPPPPPPPPPPPPPPPPPPPPPPPPPPPPPPPPPPPPPPPPPPPPPPPPPPPPPPPPPPPPPPPPPPRRRPRRRPRRRPRRRPRRRPRRRPRRRPRRR
SSSSSSSSSSSSSSSSSSSSSSSSSSSSSSSSSSSSSSSSSSSSSSSSSSSSSSSSSSSSSSSSPPPPPPPPPPPPPPPPPPPPPPPPPPPPPPPPPPPPPPPRPRRRPRRRPRRRPRRRPRRRPRRR
SSSSSSSSSSSSSSSSSSSSSSSSSSSSSSSSSSSSSSSSSSSSSSSSSSSSSSSSSSSSSSSSSSSSSSSSSSSSSSSSSSSSSSSSSSSSSPPPPPPPPPPPPRPRPRRRPRRRPRRRPRRRPRRR
SSSSSSSSSSSSSSSSSSSSSSSSSSSSSSSSSSSSSSSSSSSPPPPPPPPPPPPPPPPPPPPPPPPPPPPPPPPPPPPPPRRRPRRRPRRRPRRRPRRRPRRRPRRRPRRRPRRRPRRRPRRRPRRR
SSSSSSSSSSSSSSSSSPPPPPPPPPPPPPPPPPPPPPPPPPPPPPPPPPPPPPPPPPPPPPPPPPPPPPPPPRPRPRRRPRRRPRRRPRRRPRRRPRRRPRRRPRRRPRRRPRRRPRRRPRRRPRRR
SSSSSSSSSSSSSPPRPRRRPRRRPRRRPRRRPRRRPRRRPRRRPRRRPRRRPRRRPRRRPRRRPRRRPRRRPRRRPRRRPRRRPRRRPRRRPRRRPRRRPRRRPRRRPRRRPRRRPRRRPRRRPRRR
SSSSSSSSSSSSSSSSSSSSSSSSSPPPPPPPPPPPPPPPPPPPPPPPPPPPPPPPPPPPPPPPPPPPPPPPPPPPPPPPPPPPPPPPPPPPPPPPPPPPPPPRPRRRPRRRPRRRPRRRPRRRPRRR
SSSSSSSSSSSSSSSSSSSSSSSSSSSSSSSSSSSSSSSSSSSSSSSSSSSSSSSSSSSSSSSSSSSSSSSSSSSSSSSSSSSSSSSSPPPPPPPPPPPPPPPRPRRRPRRRPRRRPRRRPRRRPRRR
SSSSSSSSPPPPPPPPPPPPPPPPPPPPPPPPPRPRPRRRPRRRPRRRPRRRPRRRPRRRPRRRPRRRPRRRPRRRPRRRPRRRPRRRPRRRPRRRPRRRPRRRPRRRPRRRPRRRPRRRPRRRPRRR
SSSSSSSSSSSSSSSSSSSSSSSSSPPRPRRRPRRRPRRRPRRRPRRRPRRRPRRRPRRRPRRRPRRRPRRRPRRRPRRRPRRRPRRRPRRRPRRRPRRRPRRRPRRRPRRRPRRRPRRRPRRRPRRR
SSPPPPPPPPPRPRRRPRRRPRRRPRRRPRRRPRRRPRRRPRRRPRRRPRRRPRRRPRRRPRRRPRRRPRRRPRRRPRRRPRRRPRRRPRRRPRRRPRRRPRRRPRRRPRRRPRRRPRRRPRRRPRRR
SSSSSSSSSSSSSSSSSSSSSSSSSSSSSSSSSSSSSSSSSSSSSSSSSSSSSSPPPPPPPPPPPPPPPPPPPPPPPPPPPPPPPPPPPPPPPPPPPPPPPPPPPPPPPRPRPRRRPRRRPRRRPRRR
SSSSSSSSSSSSSSSSSSSSSSSSSSSSSSSSSSSSSSSSSSSSSSSSSSSSSSSSSSSSSPPPPPPPPPPPPPPPPPPPPPPPPPPPPPPPPPPPPPPPPPPPPPPRPRRRPRRRPRRRPRRRPRRR
SSSSSSSSSSSSSSSSSSSSSSSSSSSSSSSSPPPPPPPPPPPPPPPPPPPPPPPPPPPPPPPPPPPPPPPPPPPPPPPPPPPPPPPPPPPPPPPPPPPPPPPPPPPPPPPPPPPPPPPPPRRRPRRR
SSSSSSSSSSSSSSSSSSSSSSSSPRRRPRRRPRRRPRRRPRRRPRRRPRRRPRRRPRRRPRRRPRRRPRRRPRRRPRRRPRRRPRRRPRRRPRRRPRRRPRRRPRRRPRRRPRRRPRRRPRRRPRRR
SSSSSPPPPPPPPPPRPRRRPRRRPRRRPRRRPRRRPRRRPRRRPRRRPRRRPRRRPRRRPRRRPRRRPRRRPRRRPRRRPRRRPRRRPRRRPRRRPRRRPRRRPRRRPRRRPRRRPRRRPRRRPRRR
SSSSSPPPPPPPPPPPPRPRPRRRPRRRPRRRPRRRPRRRPRRRPRRRPRRRPRRRPRRRPRRRPRRRPRRRPRRRPRRRPRRRPRRRPRRRPRRRPRRRPRRRPRRRPRRRPRRRPRRRPRRRPRRR
SSSSSSSSSSSSSSSSSSSSSSSSSSSSSSSSSSSSSSSSSSSSSSSSSSSSSSSSSSSSSSSSSSSSSSSSSSSSSSSSSSSSSSSSSSSPPPPPPPPPPRPRPRRRPRRRPRRRPRRRPRRRPRRR
SSSSPRPRPRRRPRRRPRRRPRRRPRRRPRRRPRRRPRRRPRRRPRRRPRRRPRRRPRRRPRRRPRRRPRRRPRRRPRRRPRRRPRRRPRRRPRRRPRRRPRRRPRRRPRRRPRRRPRRRPRRRPRRR
SSSSSSSSSSSSSSSSSSSSSSSSSSSSSSSSSSSSSSSSSSSSSSSSSSSSSSSSPPPPPPPPPPPPPPPPPPPPPPPPPPPPPPPPPPPPPPPPPPPPPPPPPPPPPPPPPPPPPRRRPRRRPRRR
SSSSSSSSSSSSSSSSSSSSSSSSPPPPPPPPPPPPPPPPPPPPPPPPPPPPPPPPPPPPPPPPPPPPPPPPPPPPPPPPPPPPPPPPPPPPPRRRPRRRPRRRPRRRPRRRPRRRPRRRPRRRPRRR
SSSSSSSSSSSSSSSSSSSSSSSSPRPRPRRRPRRRPRRRPRRRPRRRPRRRPRRRPRRRPRRRPRRRPRRRPRRRPRRRPRRRPRRRPRRRPRRRPRRRPRRRPRRRPRRRPRRRPRRRPRRRPRRR
SSSSSSSSSSSSSSSPPPPPPPPPPPPPPPPPPPPPPPPPPPPPPPPPPPPPPPPPPPPPPPPPPPPPPPPPPPPPPPPPPPPPPPPPPPPPPPPPPPPPPPPPPRRRPRRRPRRRPRRRPRRRPRRR
SSSSSSSSSSSSSSSSSSSSSSSSSSSSSSSSSSSPPPPPPPPPPRPRPRRRPRRRPRRRPRRRPRRRPRRRPRRRPRRRPRRRPRRRPRRRPRRRPRRRPRRRPRRRPRRRPRRRPRRRPRRRPRRR
